County,Year,Conviction,Violent Felony Offenses (VFO),Drugs,DWI,Property,Other,Total
Albany,1970,Felony,9,13,0,14,6,42
Albany,1970,Misdemeanor,0,39,1,37,30,107
Allegany,1970,Felony,1,0,0,10,2,13
Allegany,1970,Misdemeanor,0,0,0,7,1,8
Bronx,1970,Felony,9,30,0,32,67,138
Bronx,1970,Misdemeanor,0,361,1,207,257,826
Broome,1970,Felony,4,15,2,25,16,62
Broome,1970,Misdemeanor,0,8,0,11,5,24
Cattaraugus,1970,Felony,0,3,1,4,4,12
Cattaraugus,1970,Misdemeanor,0,1,0,3,3,7
Cayuga,1970,Felony,0,0,0,7,0,7
Cayuga,1970,Misdemeanor,0,0,0,6,1,7
Chautauqua,1970,Felony,6,1,1,20,3,31
Chautauqua,1970,Misdemeanor,0,1,0,8,2,11
Chemung,1970,Felony,1,7,1,13,0,22
Chemung,1970,Misdemeanor,0,1,0,3,1,5
Chenango,1970,Felony,1,0,0,3,1,5
Chenango,1970,Misdemeanor,0,0,0,7,2,9
Clinton,1970,Felony,0,0,0,6,0,6
Clinton,1970,Misdemeanor,0,1,0,6,1,8
Columbia,1970,Felony,0,0,0,8,0,8
Columbia,1970,Misdemeanor,0,3,0,8,11,22
Cortland,1970,Felony,1,2,0,1,2,6
Cortland,1970,Misdemeanor,0,2,0,3,1,6
Delaware,1970,Felony,1,3,0,2,1,7
Delaware,1970,Misdemeanor,0,1,0,7,4,12
Dutchess,1970,Felony,3,3,1,7,2,16
Dutchess,1970,Misdemeanor,0,7,0,5,9,21
Erie,1970,Felony,25,23,0,37,31,116
Erie,1970,Misdemeanor,0,25,0,86,97,208
Essex,1970,Felony,0,1,0,2,2,5
Essex,1970,Misdemeanor,0,8,0,7,2,17
Franklin,1970,Felony,1,2,0,8,0,11
Franklin,1970,Misdemeanor,0,0,0,6,1,7
Fulton,1970,Felony,0,4,0,12,0,16
Fulton,1970,Misdemeanor,0,0,0,2,2,4
Genesee,1970,Felony,0,0,3,0,0,3
Genesee,1970,Misdemeanor,0,0,0,0,1,1
Greene,1970,Felony,0,3,0,6,2,11
Greene,1970,Misdemeanor,0,2,1,6,4,13
Hamilton,1970,Felony,0,1,0,0,0,1
Hamilton,1970,Misdemeanor,0,0,0,0,0,0
Herkimer,1970,Felony,4,0,0,1,0,5
Herkimer,1970,Misdemeanor,0,1,0,6,2,9
Jefferson,1970,Felony,3,1,0,10,2,16
Jefferson,1970,Misdemeanor,0,2,1,17,4,24
Kings,1970,Felony,47,26,1,32,210,316
Kings,1970,Misdemeanor,0,130,2,173,137,442
Lewis,1970,Felony,0,0,0,0,0,0
Lewis,1970,Misdemeanor,0,0,0,4,1,5
Livingston,1970,Felony,0,0,0,5,1,6
Livingston,1970,Misdemeanor,0,2,0,2,1,5
Madison,1970,Felony,0,0,0,2,0,2
Madison,1970,Misdemeanor,0,0,1,5,4,10
Monroe,1970,Felony,20,27,3,91,49,190
Monroe,1970,Misdemeanor,0,37,5,89,69,200
Montgomery,1970,Felony,1,0,1,0,0,2
Montgomery,1970,Misdemeanor,0,0,1,4,4,9
Nassau,1970,Felony,18,61,0,64,54,197
Nassau,1970,Misdemeanor,0,49,2,108,83,242
New York,1970,Felony,16,68,0,40,130,254
New York,1970,Misdemeanor,0,255,0,264,541,1060
Niagara,1970,Felony,2,3,0,4,7,16
Niagara,1970,Misdemeanor,0,3,0,28,21,52
Oneida,1970,Felony,0,4,0,18,11,33
Oneida,1970,Misdemeanor,0,8,0,15,14,37
Onondaga,1970,Felony,26,42,0,55,17,140
Onondaga,1970,Misdemeanor,0,5,0,3,2,10
Ontario,1970,Felony,2,1,0,13,0,16
Ontario,1970,Misdemeanor,0,1,1,3,4,9
Orange,1970,Felony,1,2,0,4,3,10
Orange,1970,Misdemeanor,0,9,0,6,6,21
Orleans,1970,Felony,0,0,0,1,0,1
Orleans,1970,Misdemeanor,0,0,0,1,3,4
Oswego,1970,Felony,0,1,0,2,2,5
Oswego,1970,Misdemeanor,0,0,0,5,1,6
Otsego,1970,Felony,0,1,0,5,4,10
Otsego,1970,Misdemeanor,0,1,0,3,0,4
Putnam,1970,Felony,0,2,0,1,1,4
Putnam,1970,Misdemeanor,0,4,1,2,1,8
Queens,1970,Felony,14,26,0,23,51,114
Queens,1970,Misdemeanor,0,53,0,94,148,295
Rensselaer,1970,Felony,0,2,0,7,1,10
Rensselaer,1970,Misdemeanor,0,5,0,12,12,29
Richmond,1970,Felony,0,1,0,0,1,2
Richmond,1970,Misdemeanor,0,6,0,10,7,23
Rockland,1970,Felony,2,4,1,4,4,15
Rockland,1970,Misdemeanor,0,16,0,6,10,32
St. Lawrence,1970,Felony,1,0,1,12,5,19
St. Lawrence,1970,Misdemeanor,0,4,0,7,9,20
Saratoga,1970,Felony,4,1,0,6,2,13
Saratoga,1970,Misdemeanor,0,0,0,6,2,8
Schenectady,1970,Felony,0,2,1,2,1,6
Schenectady,1970,Misdemeanor,0,5,1,6,3,15
Schoharie,1970,Felony,0,1,0,1,0,2
Schoharie,1970,Misdemeanor,0,3,0,3,3,9
Schuyler,1970,Felony,0,1,0,3,1,5
Schuyler,1970,Misdemeanor,0,0,0,0,0,0
Seneca,1970,Felony,0,0,1,1,0,2
Seneca,1970,Misdemeanor,0,1,0,4,1,6
Steuben,1970,Felony,1,4,2,3,1,11
Steuben,1970,Misdemeanor,0,0,0,3,1,4
Suffolk,1970,Felony,9,54,4,44,34,145
Suffolk,1970,Misdemeanor,0,91,3,95,77,266
Sullivan,1970,Felony,2,2,0,2,0,6
Sullivan,1970,Misdemeanor,0,0,0,1,2,3
Tioga,1970,Felony,0,1,0,5,2,8
Tioga,1970,Misdemeanor,0,1,0,0,0,1
Tompkins,1970,Felony,0,4,0,4,1,9
Tompkins,1970,Misdemeanor,0,5,1,7,1,14
Ulster,1970,Felony,1,6,0,3,1,11
Ulster,1970,Misdemeanor,0,6,0,2,2,10
Warren,1970,Felony,0,0,0,1,1,2
Warren,1970,Misdemeanor,0,0,0,3,0,3
Washington,1970,Felony,0,0,0,2,0,2
Washington,1970,Misdemeanor,0,0,0,3,1,4
Wayne,1970,Felony,2,3,0,5,3,13
Wayne,1970,Misdemeanor,0,3,0,9,6,18
Westchester,1970,Felony,18,51,1,60,21,151
Westchester,1970,Misdemeanor,0,96,3,63,45,207
Wyoming,1970,Felony,1,0,0,1,0,2
Wyoming,1970,Misdemeanor,0,1,0,0,0,1
Yates,1970,Felony,1,0,0,0,0,1
Yates,1970,Misdemeanor,0,0,0,0,0,0
Unknown,1970,Misdemeanor,0,0,0,0,0,0
Albany,1971,Felony,9,1,0,29,7,46
Albany,1971,Misdemeanor,0,18,2,54,35,109
Allegany,1971,Felony,4,8,0,12,1,25
Allegany,1971,Misdemeanor,0,8,1,10,4,23
Bronx,1971,Felony,13,68,0,34,108,223
Bronx,1971,Misdemeanor,0,586,1,460,396,1443
Broome,1971,Felony,3,21,2,44,9,79
Broome,1971,Misdemeanor,0,6,0,8,21,35
Cattaraugus,1971,Felony,3,0,2,8,5,18
Cattaraugus,1971,Misdemeanor,0,1,0,8,11,20
Cayuga,1971,Felony,0,0,0,2,2,4
Cayuga,1971,Misdemeanor,0,0,0,0,1,1
Chautauqua,1971,Felony,2,5,0,15,5,27
Chautauqua,1971,Misdemeanor,0,8,0,8,11,27
Chemung,1971,Felony,4,20,2,18,4,48
Chemung,1971,Misdemeanor,0,4,0,6,5,15
Chenango,1971,Felony,0,0,0,3,2,5
Chenango,1971,Misdemeanor,0,1,0,4,6,11
Clinton,1971,Felony,0,0,0,11,0,11
Clinton,1971,Misdemeanor,0,6,1,7,5,19
Columbia,1971,Felony,3,1,0,18,0,22
Columbia,1971,Misdemeanor,0,7,0,11,5,23
Cortland,1971,Felony,1,4,0,3,5,13
Cortland,1971,Misdemeanor,0,2,0,5,2,9
Delaware,1971,Felony,0,1,0,3,3,7
Delaware,1971,Misdemeanor,0,2,1,10,5,18
Dutchess,1971,Felony,4,11,0,3,1,19
Dutchess,1971,Misdemeanor,0,19,1,12,13,45
Erie,1971,Felony,43,26,0,55,25,149
Erie,1971,Misdemeanor,0,81,3,166,152,402
Essex,1971,Felony,1,2,0,4,1,8
Essex,1971,Misdemeanor,0,8,0,11,4,23
Franklin,1971,Felony,0,3,1,9,2,15
Franklin,1971,Misdemeanor,0,8,1,3,2,14
Fulton,1971,Felony,1,0,0,4,0,5
Fulton,1971,Misdemeanor,0,2,0,11,8,21
Genesee,1971,Felony,2,1,0,5,1,9
Genesee,1971,Misdemeanor,0,2,0,12,5,19
Greene,1971,Felony,2,2,0,7,7,18
Greene,1971,Misdemeanor,0,6,0,14,7,27
Hamilton,1971,Felony,0,0,0,1,0,1
Hamilton,1971,Misdemeanor,0,1,0,0,0,1
Herkimer,1971,Felony,1,0,0,5,1,7
Herkimer,1971,Misdemeanor,0,4,0,3,6,13
Jefferson,1971,Felony,3,10,0,26,2,41
Jefferson,1971,Misdemeanor,0,2,1,22,8,33
Kings,1971,Felony,107,118,4,79,631,939
Kings,1971,Misdemeanor,0,287,6,389,293,975
Lewis,1971,Felony,0,3,0,2,1,6
Lewis,1971,Misdemeanor,0,1,0,8,0,9
Livingston,1971,Felony,0,4,0,3,1,8
Livingston,1971,Misdemeanor,0,4,0,4,3,11
Madison,1971,Felony,1,2,0,12,2,17
Madison,1971,Misdemeanor,0,4,0,4,4,12
Monroe,1971,Felony,24,36,5,71,37,173
Monroe,1971,Misdemeanor,0,51,5,131,83,270
Montgomery,1971,Felony,0,0,0,10,0,10
Montgomery,1971,Misdemeanor,0,2,0,14,7,23
Nassau,1971,Felony,27,103,7,95,104,336
Nassau,1971,Misdemeanor,0,128,9,237,222,596
New York,1971,Felony,23,78,0,53,229,383
New York,1971,Misdemeanor,0,381,2,386,1041,1810
Niagara,1971,Felony,5,1,0,17,10,33
Niagara,1971,Misdemeanor,0,16,1,27,18,62
Oneida,1971,Felony,5,19,0,45,13,82
Oneida,1971,Misdemeanor,0,13,0,31,31,75
Onondaga,1971,Felony,35,61,0,78,26,200
Onondaga,1971,Misdemeanor,0,8,0,6,5,19
Ontario,1971,Felony,0,6,0,12,2,20
Ontario,1971,Misdemeanor,0,3,0,11,6,20
Orange,1971,Felony,2,21,1,29,21,74
Orange,1971,Misdemeanor,0,28,1,27,17,73
Orleans,1971,Felony,0,1,0,3,0,4
Orleans,1971,Misdemeanor,0,3,0,3,1,7
Oswego,1971,Felony,0,8,0,18,1,27
Oswego,1971,Misdemeanor,0,2,0,6,4,12
Otsego,1971,Felony,3,5,0,10,4,22
Otsego,1971,Misdemeanor,0,2,0,4,3,9
Putnam,1971,Felony,0,6,0,11,1,18
Putnam,1971,Misdemeanor,0,4,0,2,2,8
Queens,1971,Felony,15,77,0,52,173,317
Queens,1971,Misdemeanor,0,142,1,202,308,653
Rensselaer,1971,Felony,3,7,0,4,2,16
Rensselaer,1971,Misdemeanor,0,19,0,23,14,56
Richmond,1971,Felony,1,17,0,3,8,29
Richmond,1971,Misdemeanor,0,16,1,24,20,61
Rockland,1971,Felony,3,3,0,5,4,15
Rockland,1971,Misdemeanor,0,25,1,9,2,37
St. Lawrence,1971,Felony,3,2,0,17,5,27
St. Lawrence,1971,Misdemeanor,0,6,6,6,3,21
Saratoga,1971,Felony,2,0,0,2,1,5
Saratoga,1971,Misdemeanor,0,4,0,11,3,18
Schenectady,1971,Felony,0,2,0,5,2,9
Schenectady,1971,Misdemeanor,0,4,0,11,3,18
Schoharie,1971,Felony,1,2,0,0,2,5
Schoharie,1971,Misdemeanor,0,4,0,3,6,13
Schuyler,1971,Felony,1,0,0,2,1,4
Schuyler,1971,Misdemeanor,0,1,0,0,2,3
Seneca,1971,Felony,0,0,0,5,2,7
Seneca,1971,Misdemeanor,0,0,0,5,6,11
Steuben,1971,Felony,2,4,0,6,2,14
Steuben,1971,Misdemeanor,0,2,0,4,1,7
Suffolk,1971,Felony,7,92,0,34,40,173
Suffolk,1971,Misdemeanor,0,164,5,131,75,375
Sullivan,1971,Felony,2,2,0,4,0,8
Sullivan,1971,Misdemeanor,0,2,0,2,3,7
Tioga,1971,Felony,0,9,0,3,2,14
Tioga,1971,Misdemeanor,0,0,0,1,4,5
Tompkins,1971,Felony,1,2,2,19,6,30
Tompkins,1971,Misdemeanor,0,13,0,9,3,25
Ulster,1971,Felony,0,9,1,7,1,18
Ulster,1971,Misdemeanor,0,3,0,2,3,8
Warren,1971,Felony,1,2,0,1,0,4
Warren,1971,Misdemeanor,0,1,0,1,2,4
Washington,1971,Felony,0,1,0,5,0,6
Washington,1971,Misdemeanor,0,1,0,3,1,5
Wayne,1971,Felony,0,4,0,2,4,10
Wayne,1971,Misdemeanor,0,14,0,12,16,42
Westchester,1971,Felony,21,130,2,116,51,320
Westchester,1971,Misdemeanor,0,154,0,124,113,391
Wyoming,1971,Felony,0,1,0,7,0,8
Wyoming,1971,Misdemeanor,0,2,0,2,6,10
Yates,1971,Felony,0,0,0,4,0,4
Yates,1971,Misdemeanor,0,0,0,4,3,7
Unknown,1971,Misdemeanor,0,0,0,0,0,0
Albany,1972,Felony,11,16,0,33,17,77
Albany,1972,Misdemeanor,0,43,3,111,70,227
Allegany,1972,Felony,1,2,0,12,2,17
Allegany,1972,Misdemeanor,0,3,1,12,5,21
Bronx,1972,Felony,22,45,0,43,137,247
Bronx,1972,Misdemeanor,0,342,11,512,551,1416
Broome,1972,Felony,8,20,3,37,13,81
Broome,1972,Misdemeanor,0,7,2,17,13,39
Cattaraugus,1972,Felony,3,5,0,4,0,12
Cattaraugus,1972,Misdemeanor,0,8,1,7,7,23
Cayuga,1972,Felony,0,0,0,9,4,13
Cayuga,1972,Misdemeanor,0,0,1,1,2,4
Chautauqua,1972,Felony,1,9,0,6,4,20
Chautauqua,1972,Misdemeanor,0,2,1,38,17,58
Chemung,1972,Felony,4,18,0,16,7,45
Chemung,1972,Misdemeanor,0,9,0,8,5,22
Chenango,1972,Felony,0,1,0,3,1,5
Chenango,1972,Misdemeanor,0,3,0,14,3,20
Clinton,1972,Felony,1,0,0,15,1,17
Clinton,1972,Misdemeanor,0,1,1,17,2,21
Columbia,1972,Felony,1,2,0,10,3,16
Columbia,1972,Misdemeanor,0,5,2,9,5,21
Cortland,1972,Felony,1,4,0,4,1,10
Cortland,1972,Misdemeanor,0,3,1,13,13,30
Delaware,1972,Felony,1,2,0,4,0,7
Delaware,1972,Misdemeanor,0,3,1,16,5,25
Dutchess,1972,Felony,1,3,0,15,4,23
Dutchess,1972,Misdemeanor,0,9,0,19,15,43
Erie,1972,Felony,26,15,1,68,58,168
Erie,1972,Misdemeanor,0,64,3,174,153,394
Essex,1972,Felony,1,0,0,0,1,2
Essex,1972,Misdemeanor,0,1,1,10,2,14
Franklin,1972,Felony,2,2,0,6,1,11
Franklin,1972,Misdemeanor,0,8,1,12,3,24
Fulton,1972,Felony,2,0,0,3,0,5
Fulton,1972,Misdemeanor,0,6,0,17,5,28
Genesee,1972,Felony,2,7,1,7,2,19
Genesee,1972,Misdemeanor,0,10,3,5,15,33
Greene,1972,Felony,1,3,1,6,4,15
Greene,1972,Misdemeanor,0,5,0,5,2,12
Hamilton,1972,Felony,0,2,0,4,2,8
Hamilton,1972,Misdemeanor,0,0,0,6,3,9
Herkimer,1972,Felony,0,1,0,0,0,1
Herkimer,1972,Misdemeanor,0,3,0,14,1,18
Jefferson,1972,Felony,0,10,1,23,3,37
Jefferson,1972,Misdemeanor,0,10,0,34,7,51
Kings,1972,Felony,166,131,14,122,891,1324
Kings,1972,Misdemeanor,0,219,8,696,533,1456
Lewis,1972,Felony,0,0,0,3,0,3
Lewis,1972,Misdemeanor,0,0,0,8,3,11
Livingston,1972,Felony,0,1,0,7,2,10
Livingston,1972,Misdemeanor,0,3,2,6,5,16
Madison,1972,Felony,0,3,0,14,0,17
Madison,1972,Misdemeanor,0,2,1,10,4,17
Monroe,1972,Felony,17,38,4,62,26,147
Monroe,1972,Misdemeanor,0,77,7,203,101,388
Montgomery,1972,Felony,0,0,0,3,0,3
Montgomery,1972,Misdemeanor,0,4,0,8,1,13
Nassau,1972,Felony,27,89,7,96,126,345
Nassau,1972,Misdemeanor,0,153,25,339,288,805
New York,1972,Felony,28,68,1,91,494,682
New York,1972,Misdemeanor,0,356,8,625,1129,2118
Niagara,1972,Felony,2,2,0,2,1,7
Niagara,1972,Misdemeanor,0,10,1,31,42,84
Oneida,1972,Felony,9,5,0,29,14,57
Oneida,1972,Misdemeanor,0,18,1,55,38,112
Onondaga,1972,Felony,34,95,0,94,29,252
Onondaga,1972,Misdemeanor,0,9,0,21,14,44
Ontario,1972,Felony,0,3,1,11,2,17
Ontario,1972,Misdemeanor,0,3,1,15,11,30
Orange,1972,Felony,6,23,1,40,13,83
Orange,1972,Misdemeanor,0,33,2,22,21,78
Orleans,1972,Felony,0,1,0,0,1,2
Orleans,1972,Misdemeanor,0,2,0,5,3,10
Oswego,1972,Felony,0,6,1,25,4,36
Oswego,1972,Misdemeanor,0,3,0,11,5,19
Otsego,1972,Felony,1,6,0,8,0,15
Otsego,1972,Misdemeanor,0,7,0,12,2,21
Putnam,1972,Felony,0,3,2,6,3,14
Putnam,1972,Misdemeanor,0,6,0,9,4,19
Queens,1972,Felony,15,40,1,53,203,312
Queens,1972,Misdemeanor,0,119,11,265,350,745
Rensselaer,1972,Felony,2,6,0,6,8,22
Rensselaer,1972,Misdemeanor,0,21,0,30,22,73
Richmond,1972,Felony,6,24,2,2,32,66
Richmond,1972,Misdemeanor,0,25,1,36,50,112
Rockland,1972,Felony,3,5,0,12,2,22
Rockland,1972,Misdemeanor,0,29,1,37,33,100
St. Lawrence,1972,Felony,1,1,2,29,6,39
St. Lawrence,1972,Misdemeanor,0,1,1,18,12,32
Saratoga,1972,Felony,1,3,0,4,1,9
Saratoga,1972,Misdemeanor,0,5,0,9,6,20
Schenectady,1972,Felony,0,1,0,9,5,15
Schenectady,1972,Misdemeanor,0,2,1,7,3,13
Schoharie,1972,Felony,0,0,0,1,0,1
Schoharie,1972,Misdemeanor,0,1,0,8,0,9
Schuyler,1972,Felony,1,0,0,6,0,7
Schuyler,1972,Misdemeanor,0,2,0,0,0,2
Seneca,1972,Felony,0,0,0,0,1,1
Seneca,1972,Misdemeanor,0,1,1,5,3,10
Steuben,1972,Felony,1,6,0,7,4,18
Steuben,1972,Misdemeanor,0,5,0,20,11,36
Suffolk,1972,Felony,17,61,2,73,51,204
Suffolk,1972,Misdemeanor,0,187,7,223,126,543
Sullivan,1972,Felony,2,2,0,9,0,13
Sullivan,1972,Misdemeanor,0,8,0,6,4,18
Tioga,1972,Felony,0,7,0,9,2,18
Tioga,1972,Misdemeanor,0,0,0,1,1,2
Tompkins,1972,Felony,2,4,0,31,4,41
Tompkins,1972,Misdemeanor,0,5,1,21,14,41
Ulster,1972,Felony,4,20,1,9,3,37
Ulster,1972,Misdemeanor,0,3,0,8,5,16
Warren,1972,Felony,6,3,1,6,0,16
Warren,1972,Misdemeanor,0,8,0,9,5,22
Washington,1972,Felony,0,1,0,5,0,6
Washington,1972,Misdemeanor,0,7,0,8,8,23
Wayne,1972,Felony,1,3,1,14,1,20
Wayne,1972,Misdemeanor,0,2,0,8,9,19
Westchester,1972,Felony,41,88,7,114,73,323
Westchester,1972,Misdemeanor,0,110,12,151,127,400
Wyoming,1972,Felony,1,1,0,10,2,14
Wyoming,1972,Misdemeanor,0,0,1,9,2,12
Yates,1972,Felony,0,0,0,1,0,1
Yates,1972,Misdemeanor,0,0,0,3,1,4
Unknown,1972,Misdemeanor,0,0,0,1,0,1
Albany,1973,Felony,3,21,7,29,14,74
Albany,1973,Misdemeanor,0,56,23,91,114,284
Allegany,1973,Felony,0,2,1,2,1,6
Allegany,1973,Misdemeanor,0,2,1,10,0,13
Bronx,1973,Felony,22,40,0,70,206,338
Bronx,1973,Misdemeanor,0,106,4,451,520,1081
Broome,1973,Felony,11,13,6,67,19,116
Broome,1973,Misdemeanor,0,5,5,16,13,39
Cattaraugus,1973,Felony,0,1,1,5,2,9
Cattaraugus,1973,Misdemeanor,0,7,4,10,8,29
Cayuga,1973,Felony,0,2,0,0,0,2
Cayuga,1973,Misdemeanor,0,1,0,3,2,6
Chautauqua,1973,Felony,2,6,0,6,2,16
Chautauqua,1973,Misdemeanor,0,6,3,29,9,47
Chemung,1973,Felony,3,16,0,22,1,42
Chemung,1973,Misdemeanor,0,2,2,10,10,24
Chenango,1973,Felony,0,0,0,3,0,3
Chenango,1973,Misdemeanor,0,2,1,6,2,11
Clinton,1973,Felony,0,1,1,3,1,6
Clinton,1973,Misdemeanor,0,2,1,5,3,11
Columbia,1973,Felony,0,2,0,12,1,15
Columbia,1973,Misdemeanor,0,6,2,12,20,40
Cortland,1973,Felony,6,3,0,5,3,17
Cortland,1973,Misdemeanor,0,4,0,6,8,18
Delaware,1973,Felony,0,6,0,5,2,13
Delaware,1973,Misdemeanor,0,6,3,9,4,22
Dutchess,1973,Felony,3,0,1,13,5,22
Dutchess,1973,Misdemeanor,0,16,1,33,25,75
Erie,1973,Felony,17,24,0,40,49,130
Erie,1973,Misdemeanor,0,86,33,140,330,589
Essex,1973,Felony,0,0,0,0,0,0
Essex,1973,Misdemeanor,0,3,1,1,2,7
Franklin,1973,Felony,0,0,0,1,5,6
Franklin,1973,Misdemeanor,0,4,0,4,10,18
Fulton,1973,Felony,0,0,0,5,3,8
Fulton,1973,Misdemeanor,0,5,0,13,6,24
Genesee,1973,Felony,0,6,1,4,3,14
Genesee,1973,Misdemeanor,0,4,2,14,15,35
Greene,1973,Felony,2,18,0,7,2,29
Greene,1973,Misdemeanor,0,3,0,16,11,30
Hamilton,1973,Felony,0,3,0,2,0,5
Hamilton,1973,Misdemeanor,0,0,0,0,2,2
Herkimer,1973,Felony,3,0,0,1,0,4
Herkimer,1973,Misdemeanor,0,1,1,7,4,13
Jefferson,1973,Felony,0,0,0,6,0,6
Jefferson,1973,Misdemeanor,0,7,0,15,5,27
Kings,1973,Felony,194,175,21,162,932,1484
Kings,1973,Misdemeanor,0,96,18,540,583,1237
Lewis,1973,Felony,0,0,0,3,2,5
Lewis,1973,Misdemeanor,0,0,0,15,4,19
Livingston,1973,Felony,1,2,0,5,2,10
Livingston,1973,Misdemeanor,0,2,0,7,3,12
Madison,1973,Felony,1,3,0,8,1,13
Madison,1973,Misdemeanor,0,1,0,13,3,17
Monroe,1973,Felony,11,31,3,56,45,146
Monroe,1973,Misdemeanor,0,69,50,142,104,365
Montgomery,1973,Felony,1,0,0,0,0,1
Montgomery,1973,Misdemeanor,0,2,2,15,10,29
Nassau,1973,Felony,8,68,6,50,95,227
Nassau,1973,Misdemeanor,0,118,26,197,285,626
New York,1973,Felony,51,145,0,84,531,811
New York,1973,Misdemeanor,0,189,9,569,892,1659
Niagara,1973,Felony,1,14,0,13,4,32
Niagara,1973,Misdemeanor,0,14,1,32,22,69
Oneida,1973,Felony,9,6,1,16,13,45
Oneida,1973,Misdemeanor,0,14,1,31,30,76
Onondaga,1973,Felony,13,46,3,37,24,123
Onondaga,1973,Misdemeanor,0,38,12,30,30,110
Ontario,1973,Felony,0,1,2,9,1,13
Ontario,1973,Misdemeanor,0,4,8,16,14,42
Orange,1973,Felony,0,13,4,26,16,59
Orange,1973,Misdemeanor,0,35,11,43,36,125
Orleans,1973,Felony,0,0,0,1,0,1
Orleans,1973,Misdemeanor,0,1,1,1,3,6
Oswego,1973,Felony,0,6,1,7,2,16
Oswego,1973,Misdemeanor,0,2,0,7,1,10
Otsego,1973,Felony,1,4,1,4,1,11
Otsego,1973,Misdemeanor,0,6,2,6,5,19
Putnam,1973,Felony,0,2,0,5,2,9
Putnam,1973,Misdemeanor,0,3,0,5,1,9
Queens,1973,Felony,16,23,6,76,281,402
Queens,1973,Misdemeanor,0,71,16,276,378,741
Rensselaer,1973,Felony,2,8,0,2,4,16
Rensselaer,1973,Misdemeanor,0,10,1,32,24,67
Richmond,1973,Felony,11,14,2,20,32,79
Richmond,1973,Misdemeanor,0,18,0,25,30,73
Rockland,1973,Felony,2,6,0,11,10,29
Rockland,1973,Misdemeanor,0,22,2,31,19,74
St. Lawrence,1973,Felony,1,3,1,3,0,8
St. Lawrence,1973,Misdemeanor,0,0,0,15,6,21
Saratoga,1973,Felony,2,1,0,4,2,9
Saratoga,1973,Misdemeanor,0,2,1,10,2,15
Schenectady,1973,Felony,1,3,0,10,1,15
Schenectady,1973,Misdemeanor,0,13,2,11,13,39
Schoharie,1973,Felony,0,3,0,0,1,4
Schoharie,1973,Misdemeanor,0,0,1,7,5,13
Schuyler,1973,Felony,0,0,2,0,1,3
Schuyler,1973,Misdemeanor,0,1,0,3,5,9
Seneca,1973,Felony,0,1,0,0,0,1
Seneca,1973,Misdemeanor,0,1,0,3,2,6
Steuben,1973,Felony,0,5,0,2,2,9
Steuben,1973,Misdemeanor,0,3,4,7,13,27
Suffolk,1973,Felony,5,29,0,27,57,118
Suffolk,1973,Misdemeanor,0,165,100,162,240,667
Sullivan,1973,Felony,0,0,0,1,2,3
Sullivan,1973,Misdemeanor,0,4,5,18,8,35
Tioga,1973,Felony,2,4,0,7,1,14
Tioga,1973,Misdemeanor,0,3,0,2,2,7
Tompkins,1973,Felony,1,8,0,17,5,31
Tompkins,1973,Misdemeanor,0,8,2,15,12,37
Ulster,1973,Felony,0,10,0,4,3,17
Ulster,1973,Misdemeanor,0,3,1,8,7,19
Warren,1973,Felony,0,0,1,4,1,6
Warren,1973,Misdemeanor,0,1,2,17,2,22
Washington,1973,Felony,0,1,0,0,0,1
Washington,1973,Misdemeanor,0,0,0,7,1,8
Wayne,1973,Felony,2,4,4,13,2,25
Wayne,1973,Misdemeanor,0,1,1,8,7,17
Westchester,1973,Felony,18,45,3,51,33,150
Westchester,1973,Misdemeanor,0,65,32,112,122,331
Wyoming,1973,Felony,0,1,0,4,0,5
Wyoming,1973,Misdemeanor,0,2,0,6,5,13
Yates,1973,Felony,0,3,0,0,0,3
Yates,1973,Misdemeanor,0,0,1,1,0,2
Unknown,1973,Misdemeanor,0,0,0,0,0,0
Albany,1974,Felony,4,4,1,12,12,33
Albany,1974,Misdemeanor,0,49,24,183,116,372
Allegany,1974,Felony,0,1,0,2,3,6
Allegany,1974,Misdemeanor,0,7,1,18,1,27
Bronx,1974,Felony,38,23,0,55,263,379
Bronx,1974,Misdemeanor,0,98,14,661,390,1163
Broome,1974,Felony,8,17,4,83,21,133
Broome,1974,Misdemeanor,0,7,4,19,12,42
Cattaraugus,1974,Felony,0,3,0,1,1,5
Cattaraugus,1974,Misdemeanor,0,11,1,21,11,44
Cayuga,1974,Felony,0,0,0,4,0,4
Cayuga,1974,Misdemeanor,0,2,2,2,3,9
Chautauqua,1974,Felony,3,2,2,3,1,11
Chautauqua,1974,Misdemeanor,0,8,5,58,24,95
Chemung,1974,Felony,2,19,0,28,6,55
Chemung,1974,Misdemeanor,0,11,1,18,8,38
Chenango,1974,Felony,0,1,0,0,0,1
Chenango,1974,Misdemeanor,0,8,0,9,1,18
Clinton,1974,Felony,2,1,0,4,0,7
Clinton,1974,Misdemeanor,0,8,1,22,12,43
Columbia,1974,Felony,1,4,0,25,3,33
Columbia,1974,Misdemeanor,0,8,3,31,16,58
Cortland,1974,Felony,1,2,0,7,1,11
Cortland,1974,Misdemeanor,0,6,0,8,9,23
Delaware,1974,Felony,0,0,0,2,0,2
Delaware,1974,Misdemeanor,0,7,0,10,2,19
Dutchess,1974,Felony,8,15,2,39,19,83
Dutchess,1974,Misdemeanor,0,14,2,61,30,107
Erie,1974,Felony,17,34,0,50,43,144
Erie,1974,Misdemeanor,0,171,84,445,430,1130
Essex,1974,Felony,2,0,0,2,0,4
Essex,1974,Misdemeanor,0,4,2,11,2,19
Franklin,1974,Felony,0,2,0,9,1,12
Franklin,1974,Misdemeanor,0,2,1,6,5,14
Fulton,1974,Felony,0,4,2,6,1,13
Fulton,1974,Misdemeanor,0,10,0,24,5,39
Genesee,1974,Felony,0,1,2,2,2,7
Genesee,1974,Misdemeanor,0,8,6,18,12,44
Greene,1974,Felony,1,5,1,18,8,33
Greene,1974,Misdemeanor,0,3,1,27,6,37
Hamilton,1974,Felony,0,3,0,2,1,6
Hamilton,1974,Misdemeanor,0,1,1,0,0,2
Herkimer,1974,Felony,0,1,0,4,2,7
Herkimer,1974,Misdemeanor,0,4,0,9,4,17
Jefferson,1974,Felony,1,0,0,10,0,11
Jefferson,1974,Misdemeanor,0,5,0,15,4,24
Kings,1974,Felony,147,67,15,193,739,1161
Kings,1974,Misdemeanor,0,81,33,1079,813,2006
Lewis,1974,Felony,0,0,1,1,1,3
Lewis,1974,Misdemeanor,0,1,0,23,11,35
Livingston,1974,Felony,0,0,0,3,2,5
Livingston,1974,Misdemeanor,0,2,4,8,4,18
Madison,1974,Felony,1,1,0,11,1,14
Madison,1974,Misdemeanor,0,5,0,10,9,24
Monroe,1974,Felony,10,22,7,76,41,156
Monroe,1974,Misdemeanor,0,89,23,263,108,483
Montgomery,1974,Felony,0,1,0,3,1,5
Montgomery,1974,Misdemeanor,0,4,0,16,11,31
Nassau,1974,Felony,18,33,40,56,80,227
Nassau,1974,Misdemeanor,0,98,94,209,205,606
New York,1974,Felony,64,97,2,136,568,867
New York,1974,Misdemeanor,0,286,14,1117,786,2203
Niagara,1974,Felony,2,11,0,9,2,24
Niagara,1974,Misdemeanor,0,22,2,74,26,124
Oneida,1974,Felony,5,30,3,30,8,76
Oneida,1974,Misdemeanor,0,35,2,69,42,148
Onondaga,1974,Felony,14,37,1,57,15,124
Onondaga,1974,Misdemeanor,0,33,7,87,42,169
Ontario,1974,Felony,2,7,1,19,1,30
Ontario,1974,Misdemeanor,0,9,2,37,17,65
Orange,1974,Felony,0,9,6,17,10,42
Orange,1974,Misdemeanor,0,36,8,79,47,170
Orleans,1974,Felony,0,0,1,4,1,6
Orleans,1974,Misdemeanor,0,6,0,7,6,19
Oswego,1974,Felony,0,3,0,19,1,23
Oswego,1974,Misdemeanor,0,6,0,14,3,23
Otsego,1974,Felony,0,3,0,0,1,4
Otsego,1974,Misdemeanor,0,7,1,7,1,16
Putnam,1974,Felony,0,1,0,3,0,4
Putnam,1974,Misdemeanor,0,1,0,1,0,2
Queens,1974,Felony,27,28,0,94,202,351
Queens,1974,Misdemeanor,0,95,17,544,236,892
Rensselaer,1974,Felony,1,2,0,6,4,13
Rensselaer,1974,Misdemeanor,0,11,1,65,17,94
Richmond,1974,Felony,13,21,0,40,30,104
Richmond,1974,Misdemeanor,0,8,5,48,55,116
Rockland,1974,Felony,0,1,0,8,4,13
Rockland,1974,Misdemeanor,0,22,3,71,25,121
St. Lawrence,1974,Felony,0,1,0,4,2,7
St. Lawrence,1974,Misdemeanor,0,5,0,18,9,32
Saratoga,1974,Felony,0,2,0,5,3,10
Saratoga,1974,Misdemeanor,0,5,2,13,4,24
Schenectady,1974,Felony,4,5,1,9,5,24
Schenectady,1974,Misdemeanor,0,8,1,33,8,50
Schoharie,1974,Felony,0,0,0,0,0,0
Schoharie,1974,Misdemeanor,0,0,0,9,2,11
Schuyler,1974,Felony,0,2,1,3,0,6
Schuyler,1974,Misdemeanor,0,6,0,11,5,22
Seneca,1974,Felony,0,0,0,1,0,1
Seneca,1974,Misdemeanor,0,2,0,15,7,24
Steuben,1974,Felony,0,2,1,5,1,9
Steuben,1974,Misdemeanor,0,5,0,38,8,51
Suffolk,1974,Felony,5,29,4,33,66,137
Suffolk,1974,Misdemeanor,0,157,166,353,255,931
Sullivan,1974,Felony,2,4,1,8,6,21
Sullivan,1974,Misdemeanor,0,10,21,15,9,55
Tioga,1974,Felony,2,1,1,21,3,28
Tioga,1974,Misdemeanor,0,1,0,9,4,14
Tompkins,1974,Felony,1,21,1,13,5,41
Tompkins,1974,Misdemeanor,0,4,0,10,11,25
Ulster,1974,Felony,4,8,0,8,7,27
Ulster,1974,Misdemeanor,0,5,0,21,9,35
Warren,1974,Felony,1,3,0,4,2,10
Warren,1974,Misdemeanor,0,1,2,37,7,47
Washington,1974,Felony,0,2,0,6,4,12
Washington,1974,Misdemeanor,0,0,0,12,10,22
Wayne,1974,Felony,0,4,10,37,5,56
Wayne,1974,Misdemeanor,0,2,2,15,3,22
Westchester,1974,Felony,19,45,19,53,36,172
Westchester,1974,Misdemeanor,0,88,27,169,120,404
Wyoming,1974,Felony,0,1,0,4,2,7
Wyoming,1974,Misdemeanor,0,1,2,7,4,14
Yates,1974,Felony,0,0,0,2,0,2
Yates,1974,Misdemeanor,0,1,0,5,0,6
Unknown,1974,Misdemeanor,0,0,0,0,0,0
Albany,1975,Felony,3,9,4,40,20,76
Albany,1975,Misdemeanor,0,22,6,183,84,295
Allegany,1975,Felony,0,0,0,2,0,2
Allegany,1975,Misdemeanor,0,1,1,23,4,29
Bronx,1975,Felony,20,25,0,67,217,329
Bronx,1975,Misdemeanor,0,52,6,530,245,833
Broome,1975,Felony,21,23,3,101,25,173
Broome,1975,Misdemeanor,0,7,0,16,17,40
Cattaraugus,1975,Felony,1,0,1,1,1,4
Cattaraugus,1975,Misdemeanor,0,6,1,38,17,62
Cayuga,1975,Felony,1,0,1,7,2,11
Cayuga,1975,Misdemeanor,0,2,1,4,2,9
Chautauqua,1975,Felony,2,0,2,19,3,26
Chautauqua,1975,Misdemeanor,0,13,2,61,30,106
Chemung,1975,Felony,14,10,5,56,10,95
Chemung,1975,Misdemeanor,0,2,9,14,5,30
Chenango,1975,Felony,0,1,0,3,1,5
Chenango,1975,Misdemeanor,0,4,2,23,13,42
Clinton,1975,Felony,1,9,0,8,3,21
Clinton,1975,Misdemeanor,0,3,0,10,7,20
Columbia,1975,Felony,1,4,0,12,4,21
Columbia,1975,Misdemeanor,0,9,1,27,10,47
Cortland,1975,Felony,1,1,1,19,4,26
Cortland,1975,Misdemeanor,0,3,1,18,13,35
Delaware,1975,Felony,0,4,0,13,0,17
Delaware,1975,Misdemeanor,0,2,0,7,3,12
Dutchess,1975,Felony,1,10,1,55,10,77
Dutchess,1975,Misdemeanor,0,12,4,102,33,151
Erie,1975,Felony,7,48,6,58,76,195
Erie,1975,Misdemeanor,0,158,105,491,316,1070
Essex,1975,Felony,1,0,0,3,2,6
Essex,1975,Misdemeanor,0,4,0,17,3,24
Franklin,1975,Felony,3,10,0,10,0,23
Franklin,1975,Misdemeanor,0,2,0,10,4,16
Fulton,1975,Felony,3,2,1,11,2,19
Fulton,1975,Misdemeanor,0,5,0,29,8,42
Genesee,1975,Felony,2,2,6,10,1,21
Genesee,1975,Misdemeanor,0,4,3,25,12,44
Greene,1975,Felony,1,6,1,14,5,27
Greene,1975,Misdemeanor,0,15,3,30,9,57
Hamilton,1975,Felony,0,4,0,3,2,9
Hamilton,1975,Misdemeanor,0,0,0,3,2,5
Herkimer,1975,Felony,1,6,0,2,0,9
Herkimer,1975,Misdemeanor,0,5,0,12,0,17
Jefferson,1975,Felony,1,3,0,12,4,20
Jefferson,1975,Misdemeanor,0,8,1,15,7,31
Kings,1975,Felony,159,64,9,232,815,1279
Kings,1975,Misdemeanor,0,101,24,1350,683,2158
Lewis,1975,Felony,0,1,0,0,1,2
Lewis,1975,Misdemeanor,0,3,0,18,4,25
Livingston,1975,Felony,0,6,0,3,0,9
Livingston,1975,Misdemeanor,0,2,1,16,4,23
Madison,1975,Felony,1,1,3,15,0,20
Madison,1975,Misdemeanor,0,2,1,19,7,29
Monroe,1975,Felony,5,40,10,134,42,231
Monroe,1975,Misdemeanor,0,57,14,286,121,478
Montgomery,1975,Felony,0,0,0,2,0,2
Montgomery,1975,Misdemeanor,0,0,0,17,2,19
Nassau,1975,Felony,23,51,73,111,85,343
Nassau,1975,Misdemeanor,0,121,198,475,289,1083
New York,1975,Felony,123,108,1,107,463,802
New York,1975,Misdemeanor,0,344,14,1313,590,2261
Niagara,1975,Felony,0,17,0,11,5,33
Niagara,1975,Misdemeanor,0,31,6,109,31,177
Oneida,1975,Felony,5,36,8,50,23,122
Oneida,1975,Misdemeanor,0,23,6,93,45,167
Onondaga,1975,Felony,18,43,15,63,17,156
Onondaga,1975,Misdemeanor,0,31,15,96,40,182
Ontario,1975,Felony,6,3,0,20,0,29
Ontario,1975,Misdemeanor,0,5,4,27,12,48
Orange,1975,Felony,4,2,18,16,14,54
Orange,1975,Misdemeanor,0,32,10,78,51,171
Orleans,1975,Felony,4,0,4,6,1,15
Orleans,1975,Misdemeanor,0,2,2,21,18,43
Oswego,1975,Felony,0,2,1,27,3,33
Oswego,1975,Misdemeanor,0,5,0,21,5,31
Otsego,1975,Felony,0,2,0,5,2,9
Otsego,1975,Misdemeanor,0,2,1,14,3,20
Putnam,1975,Felony,0,0,1,1,0,2
Putnam,1975,Misdemeanor,0,3,0,4,5,12
Queens,1975,Felony,42,44,1,133,293,513
Queens,1975,Misdemeanor,0,88,11,715,245,1059
Rensselaer,1975,Felony,0,2,0,9,5,16
Rensselaer,1975,Misdemeanor,0,8,1,48,34,91
Richmond,1975,Felony,18,5,2,35,24,84
Richmond,1975,Misdemeanor,0,4,3,61,35,103
Rockland,1975,Felony,1,3,2,5,11,22
Rockland,1975,Misdemeanor,0,15,3,76,30,124
St. Lawrence,1975,Felony,1,2,1,9,1,14
St. Lawrence,1975,Misdemeanor,0,7,0,20,10,37
Saratoga,1975,Felony,4,4,0,15,2,25
Saratoga,1975,Misdemeanor,0,6,0,11,5,22
Schenectady,1975,Felony,2,9,0,19,3,33
Schenectady,1975,Misdemeanor,0,6,2,44,12,64
Schoharie,1975,Felony,0,0,0,1,0,1
Schoharie,1975,Misdemeanor,0,4,0,7,2,13
Schuyler,1975,Felony,0,0,0,3,1,4
Schuyler,1975,Misdemeanor,0,3,0,20,6,29
Seneca,1975,Felony,0,0,0,1,0,1
Seneca,1975,Misdemeanor,0,4,1,15,4,24
Steuben,1975,Felony,2,4,0,11,25,42
Steuben,1975,Misdemeanor,0,7,0,46,17,70
Suffolk,1975,Felony,21,41,4,94,94,254
Suffolk,1975,Misdemeanor,0,156,258,624,268,1306
Sullivan,1975,Felony,3,0,2,4,0,9
Sullivan,1975,Misdemeanor,0,9,0,41,15,65
Tioga,1975,Felony,1,5,0,7,2,15
Tioga,1975,Misdemeanor,0,1,0,4,4,9
Tompkins,1975,Felony,1,2,0,12,6,21
Tompkins,1975,Misdemeanor,0,16,4,16,4,40
Ulster,1975,Felony,1,7,0,20,8,36
Ulster,1975,Misdemeanor,0,4,0,24,15,43
Warren,1975,Felony,2,2,0,4,1,9
Warren,1975,Misdemeanor,0,11,0,27,11,49
Washington,1975,Felony,2,0,2,2,0,6
Washington,1975,Misdemeanor,0,2,0,6,2,10
Wayne,1975,Felony,4,2,7,21,2,36
Wayne,1975,Misdemeanor,0,5,0,12,11,28
Westchester,1975,Felony,12,51,39,113,70,285
Westchester,1975,Misdemeanor,0,64,14,275,146,499
Wyoming,1975,Felony,4,1,0,10,0,15
Wyoming,1975,Misdemeanor,0,1,2,5,6,14
Yates,1975,Felony,0,0,0,15,2,17
Yates,1975,Misdemeanor,0,2,0,2,4,8
Unknown,1975,Misdemeanor,0,0,0,0,0,0
Albany,1976,Felony,5,8,3,52,13,81
Albany,1976,Misdemeanor,0,35,17,207,98,357
Allegany,1976,Felony,0,1,0,1,2,4
Allegany,1976,Misdemeanor,0,0,0,25,6,31
Bronx,1976,Felony,52,38,0,99,243,432
Bronx,1976,Misdemeanor,0,20,0,387,185,592
Broome,1976,Felony,14,19,9,98,28,168
Broome,1976,Misdemeanor,0,3,0,24,6,33
Cattaraugus,1976,Felony,0,3,0,1,0,4
Cattaraugus,1976,Misdemeanor,0,5,0,44,9,58
Cayuga,1976,Felony,0,0,0,11,0,11
Cayuga,1976,Misdemeanor,0,0,0,12,3,15
Chautauqua,1976,Felony,1,1,1,17,4,24
Chautauqua,1976,Misdemeanor,0,3,4,47,25,79
Chemung,1976,Felony,4,16,6,23,7,56
Chemung,1976,Misdemeanor,0,1,10,19,8,38
Chenango,1976,Felony,0,1,0,2,0,3
Chenango,1976,Misdemeanor,0,7,0,28,7,42
Clinton,1976,Felony,1,2,0,13,2,18
Clinton,1976,Misdemeanor,0,1,1,19,10,31
Columbia,1976,Felony,0,3,0,2,1,6
Columbia,1976,Misdemeanor,0,4,2,29,12,47
Cortland,1976,Felony,0,2,2,12,6,22
Cortland,1976,Misdemeanor,0,7,4,18,10,39
Delaware,1976,Felony,0,2,0,7,0,9
Delaware,1976,Misdemeanor,0,1,0,9,2,12
Dutchess,1976,Felony,9,3,1,63,17,93
Dutchess,1976,Misdemeanor,0,14,5,142,46,207
Erie,1976,Felony,20,42,13,51,67,193
Erie,1976,Misdemeanor,0,126,97,517,344,1084
Essex,1976,Felony,1,0,0,3,0,4
Essex,1976,Misdemeanor,0,3,1,19,3,26
Franklin,1976,Felony,0,5,0,11,1,17
Franklin,1976,Misdemeanor,0,8,0,11,2,21
Fulton,1976,Felony,2,2,1,5,0,10
Fulton,1976,Misdemeanor,0,11,1,30,8,50
Genesee,1976,Felony,3,2,3,6,0,14
Genesee,1976,Misdemeanor,0,6,0,41,27,74
Greene,1976,Felony,2,5,4,20,3,34
Greene,1976,Misdemeanor,0,10,6,51,15,82
Hamilton,1976,Felony,0,1,0,1,0,2
Hamilton,1976,Misdemeanor,0,1,0,2,2,5
Herkimer,1976,Felony,1,2,0,4,2,9
Herkimer,1976,Misdemeanor,0,3,0,19,8,30
Jefferson,1976,Felony,0,3,0,10,3,16
Jefferson,1976,Misdemeanor,0,4,6,21,11,42
Kings,1976,Felony,124,48,2,173,636,983
Kings,1976,Misdemeanor,0,92,21,1285,548,1946
Lewis,1976,Felony,0,0,0,6,1,7
Lewis,1976,Misdemeanor,0,0,0,21,1,22
Livingston,1976,Felony,0,2,0,17,2,21
Livingston,1976,Misdemeanor,0,2,3,21,6,32
Madison,1976,Felony,0,1,0,7,2,10
Madison,1976,Misdemeanor,0,3,1,15,7,26
Monroe,1976,Felony,10,23,20,120,78,251
Monroe,1976,Misdemeanor,0,37,5,265,114,421
Montgomery,1976,Felony,0,0,0,4,1,5
Montgomery,1976,Misdemeanor,0,3,0,21,6,30
Nassau,1976,Felony,19,76,28,129,90,342
Nassau,1976,Misdemeanor,0,117,257,548,320,1242
New York,1976,Felony,88,76,0,73,299,536
New York,1976,Misdemeanor,0,268,6,969,438,1681
Niagara,1976,Felony,2,5,1,17,10,35
Niagara,1976,Misdemeanor,0,14,2,106,24,146
Oneida,1976,Felony,3,15,19,39,11,87
Oneida,1976,Misdemeanor,0,10,4,63,30,107
Onondaga,1976,Felony,6,26,13,68,36,149
Onondaga,1976,Misdemeanor,0,18,10,69,34,131
Ontario,1976,Felony,0,3,7,31,0,41
Ontario,1976,Misdemeanor,0,5,1,28,16,50
Orange,1976,Felony,0,10,8,24,10,52
Orange,1976,Misdemeanor,0,33,5,85,34,157
Orleans,1976,Felony,0,1,5,7,0,13
Orleans,1976,Misdemeanor,0,3,2,9,7,21
Oswego,1976,Felony,0,3,7,30,8,48
Oswego,1976,Misdemeanor,0,3,0,23,5,31
Otsego,1976,Felony,0,1,1,1,0,3
Otsego,1976,Misdemeanor,0,3,0,9,6,18
Putnam,1976,Felony,1,0,0,1,0,2
Putnam,1976,Misdemeanor,0,0,0,5,2,7
Queens,1976,Felony,25,39,2,110,219,395
Queens,1976,Misdemeanor,0,77,13,610,174,874
Rensselaer,1976,Felony,0,3,1,8,7,19
Rensselaer,1976,Misdemeanor,0,7,1,49,18,75
Richmond,1976,Felony,13,6,1,30,21,71
Richmond,1976,Misdemeanor,0,3,3,44,15,65
Rockland,1976,Felony,0,13,1,31,11,56
Rockland,1976,Misdemeanor,0,17,2,50,24,93
St. Lawrence,1976,Felony,0,3,0,10,2,15
St. Lawrence,1976,Misdemeanor,0,10,0,28,15,53
Saratoga,1976,Felony,1,3,0,15,7,26
Saratoga,1976,Misdemeanor,0,8,0,24,8,40
Schenectady,1976,Felony,4,10,0,31,1,46
Schenectady,1976,Misdemeanor,0,2,0,59,20,81
Schoharie,1976,Felony,1,0,0,0,0,1
Schoharie,1976,Misdemeanor,0,1,0,6,6,13
Schuyler,1976,Felony,0,0,0,2,1,3
Schuyler,1976,Misdemeanor,0,5,2,20,11,38
Seneca,1976,Felony,0,0,0,3,0,3
Seneca,1976,Misdemeanor,0,0,2,12,2,16
Steuben,1976,Felony,0,2,1,17,4,24
Steuben,1976,Misdemeanor,0,4,0,24,12,40
Suffolk,1976,Felony,17,56,7,131,80,291
Suffolk,1976,Misdemeanor,0,106,163,847,298,1414
Sullivan,1976,Felony,0,0,0,6,4,10
Sullivan,1976,Misdemeanor,0,1,4,46,9,60
Tioga,1976,Felony,1,15,1,10,1,28
Tioga,1976,Misdemeanor,0,0,1,9,3,13
Tompkins,1976,Felony,0,2,0,12,1,15
Tompkins,1976,Misdemeanor,0,3,2,29,6,40
Ulster,1976,Felony,4,4,0,20,8,36
Ulster,1976,Misdemeanor,0,10,0,39,24,73
Warren,1976,Felony,1,0,0,0,2,3
Warren,1976,Misdemeanor,0,5,0,27,5,37
Washington,1976,Felony,0,0,1,1,1,3
Washington,1976,Misdemeanor,0,3,0,12,3,18
Wayne,1976,Felony,0,3,7,19,4,33
Wayne,1976,Misdemeanor,0,6,1,16,6,29
Westchester,1976,Felony,13,53,55,113,52,286
Westchester,1976,Misdemeanor,0,63,7,269,196,535
Wyoming,1976,Felony,1,0,0,12,4,17
Wyoming,1976,Misdemeanor,0,2,0,5,3,10
Yates,1976,Felony,0,0,0,3,0,3
Yates,1976,Misdemeanor,0,3,3,4,2,12
Unknown,1976,Misdemeanor,0,0,0,0,0,0
Albany,1977,Felony,1,2,4,20,8,35
Albany,1977,Misdemeanor,0,10,19,110,56,195
Allegany,1977,Felony,1,0,0,6,0,7
Allegany,1977,Misdemeanor,0,0,0,16,0,16
Bronx,1977,Felony,38,45,0,107,195,385
Bronx,1977,Misdemeanor,0,20,9,541,251,821
Broome,1977,Felony,6,13,7,57,6,89
Broome,1977,Misdemeanor,0,2,3,12,15,32
Cattaraugus,1977,Felony,0,0,0,2,2,4
Cattaraugus,1977,Misdemeanor,0,1,0,9,5,15
Cayuga,1977,Felony,0,0,0,8,0,8
Cayuga,1977,Misdemeanor,0,0,0,8,0,8
Chautauqua,1977,Felony,1,0,0,9,1,11
Chautauqua,1977,Misdemeanor,0,4,4,29,11,48
Chemung,1977,Felony,4,6,7,24,10,51
Chemung,1977,Misdemeanor,0,0,2,8,4,14
Chenango,1977,Felony,0,0,1,2,0,3
Chenango,1977,Misdemeanor,0,0,0,12,2,14
Clinton,1977,Felony,0,3,1,9,2,15
Clinton,1977,Misdemeanor,0,2,0,9,1,12
Columbia,1977,Felony,0,0,0,1,0,1
Columbia,1977,Misdemeanor,0,1,0,10,4,15
Cortland,1977,Felony,3,0,3,5,3,14
Cortland,1977,Misdemeanor,0,3,3,8,3,17
Delaware,1977,Felony,0,0,0,4,3,7
Delaware,1977,Misdemeanor,0,0,0,11,3,14
Dutchess,1977,Felony,1,0,2,34,11,48
Dutchess,1977,Misdemeanor,0,6,2,55,18,81
Erie,1977,Felony,15,26,15,62,48,166
Erie,1977,Misdemeanor,0,43,53,304,160,560
Essex,1977,Felony,0,1,0,4,1,6
Essex,1977,Misdemeanor,0,0,0,3,1,4
Franklin,1977,Felony,1,0,1,4,2,8
Franklin,1977,Misdemeanor,0,2,0,10,3,15
Fulton,1977,Felony,0,0,0,2,1,3
Fulton,1977,Misdemeanor,0,3,5,10,8,26
Genesee,1977,Felony,2,0,1,9,2,14
Genesee,1977,Misdemeanor,0,1,1,5,5,12
Greene,1977,Felony,0,3,0,13,5,21
Greene,1977,Misdemeanor,0,4,1,29,16,50
Hamilton,1977,Felony,1,0,0,0,0,1
Hamilton,1977,Misdemeanor,0,0,0,1,0,1
Herkimer,1977,Felony,2,2,0,0,1,5
Herkimer,1977,Misdemeanor,0,5,1,12,1,19
Jefferson,1977,Felony,0,0,0,36,5,41
Jefferson,1977,Misdemeanor,0,4,1,18,12,35
Kings,1977,Felony,82,40,2,149,347,620
Kings,1977,Misdemeanor,0,40,13,1270,433,1756
Lewis,1977,Felony,1,0,0,3,0,4
Lewis,1977,Misdemeanor,0,2,0,3,2,7
Livingston,1977,Felony,0,1,0,10,1,12
Livingston,1977,Misdemeanor,0,0,0,13,3,16
Madison,1977,Felony,0,0,4,9,1,14
Madison,1977,Misdemeanor,0,1,0,14,5,20
Monroe,1977,Felony,13,15,25,99,42,194
Monroe,1977,Misdemeanor,0,5,10,142,40,197
Montgomery,1977,Felony,0,0,0,0,0,0
Montgomery,1977,Misdemeanor,0,1,1,12,6,20
Nassau,1977,Felony,17,52,29,134,64,296
Nassau,1977,Misdemeanor,0,26,92,305,154,577
New York,1977,Felony,86,96,0,102,322,606
New York,1977,Misdemeanor,0,328,8,983,409,1728
Niagara,1977,Felony,1,1,0,14,6,22
Niagara,1977,Misdemeanor,0,5,0,56,6,67
Oneida,1977,Felony,1,4,12,54,8,79
Oneida,1977,Misdemeanor,0,3,4,16,15,38
Onondaga,1977,Felony,6,14,6,57,32,115
Onondaga,1977,Misdemeanor,0,10,9,50,31,100
Ontario,1977,Felony,1,0,10,29,0,40
Ontario,1977,Misdemeanor,0,1,2,7,4,14
Orange,1977,Felony,0,1,9,10,9,29
Orange,1977,Misdemeanor,0,5,3,40,13,61
Orleans,1977,Felony,1,0,3,1,0,5
Orleans,1977,Misdemeanor,0,2,0,7,8,17
Oswego,1977,Felony,1,3,2,23,12,41
Oswego,1977,Misdemeanor,0,1,2,12,6,21
Otsego,1977,Felony,0,1,0,2,0,3
Otsego,1977,Misdemeanor,0,4,0,8,0,12
Putnam,1977,Felony,0,2,0,5,0,7
Putnam,1977,Misdemeanor,0,1,1,9,2,13
Queens,1977,Felony,23,32,0,101,188,344
Queens,1977,Misdemeanor,0,101,8,606,173,888
Rensselaer,1977,Felony,1,0,4,8,2,15
Rensselaer,1977,Misdemeanor,0,6,5,19,8,38
Richmond,1977,Felony,8,7,0,47,38,100
Richmond,1977,Misdemeanor,0,12,1,108,46,167
Rockland,1977,Felony,0,5,7,27,7,46
Rockland,1977,Misdemeanor,0,5,0,85,31,121
St. Lawrence,1977,Felony,0,1,2,2,2,7
St. Lawrence,1977,Misdemeanor,0,2,2,12,4,20
Saratoga,1977,Felony,0,1,0,2,4,7
Saratoga,1977,Misdemeanor,0,2,0,11,4,17
Schenectady,1977,Felony,1,2,0,9,3,15
Schenectady,1977,Misdemeanor,0,0,1,17,9,27
Schoharie,1977,Felony,1,2,0,2,1,6
Schoharie,1977,Misdemeanor,0,0,0,4,0,4
Schuyler,1977,Felony,1,0,0,2,0,3
Schuyler,1977,Misdemeanor,0,0,0,5,2,7
Seneca,1977,Felony,1,1,0,4,1,7
Seneca,1977,Misdemeanor,0,0,0,5,3,8
Steuben,1977,Felony,1,2,2,26,1,32
Steuben,1977,Misdemeanor,0,1,0,16,6,23
Suffolk,1977,Felony,21,31,7,130,79,268
Suffolk,1977,Misdemeanor,0,54,159,562,255,1030
Sullivan,1977,Felony,3,2,3,5,3,16
Sullivan,1977,Misdemeanor,0,2,3,19,8,32
Tioga,1977,Felony,5,0,0,7,0,12
Tioga,1977,Misdemeanor,0,0,0,7,2,9
Tompkins,1977,Felony,0,2,1,2,5,10
Tompkins,1977,Misdemeanor,0,5,2,25,12,44
Ulster,1977,Felony,6,9,0,16,3,34
Ulster,1977,Misdemeanor,0,2,0,6,2,10
Warren,1977,Felony,0,0,0,2,1,3
Warren,1977,Misdemeanor,0,4,0,18,5,27
Washington,1977,Felony,0,1,2,3,2,8
Washington,1977,Misdemeanor,0,0,2,5,2,9
Wayne,1977,Felony,0,0,1,4,0,5
Wayne,1977,Misdemeanor,0,1,1,8,4,14
Westchester,1977,Felony,12,18,42,76,47,195
Westchester,1977,Misdemeanor,0,39,7,140,70,256
Wyoming,1977,Felony,0,0,1,2,0,3
Wyoming,1977,Misdemeanor,0,0,0,5,1,6
Yates,1977,Felony,0,0,0,2,0,2
Yates,1977,Misdemeanor,0,1,0,1,1,3
Unknown,1977,Misdemeanor,0,0,0,0,0,0
Albany,1978,Felony,7,1,7,31,12,58
Albany,1978,Misdemeanor,0,27,59,261,112,459
Allegany,1978,Felony,0,0,1,6,1,8
Allegany,1978,Misdemeanor,0,0,1,20,2,23
Bronx,1978,Felony,73,34,0,159,274,540
Bronx,1978,Misdemeanor,0,37,8,495,233,773
Broome,1978,Felony,16,7,17,84,18,142
Broome,1978,Misdemeanor,0,2,3,39,25,69
Cattaraugus,1978,Felony,3,2,7,17,4,33
Cattaraugus,1978,Misdemeanor,0,3,3,18,6,30
Cayuga,1978,Felony,0,0,1,12,3,16
Cayuga,1978,Misdemeanor,0,0,0,16,10,26
Chautauqua,1978,Felony,2,1,3,28,9,43
Chautauqua,1978,Misdemeanor,0,2,3,69,35,109
Chemung,1978,Felony,3,3,10,32,10,58
Chemung,1978,Misdemeanor,0,2,33,39,25,99
Chenango,1978,Felony,0,0,4,2,0,6
Chenango,1978,Misdemeanor,0,0,3,23,3,29
Clinton,1978,Felony,1,1,4,8,1,15
Clinton,1978,Misdemeanor,0,0,2,43,10,55
Columbia,1978,Felony,0,0,2,4,0,6
Columbia,1978,Misdemeanor,0,2,3,22,11,38
Cortland,1978,Felony,1,0,0,14,4,19
Cortland,1978,Misdemeanor,0,0,3,13,7,23
Delaware,1978,Felony,0,1,0,4,1,6
Delaware,1978,Misdemeanor,0,1,0,24,6,31
Dutchess,1978,Felony,1,0,2,47,13,63
Dutchess,1978,Misdemeanor,0,9,11,99,27,146
Erie,1978,Felony,11,17,31,58,49,166
Erie,1978,Misdemeanor,0,57,93,527,304,981
Essex,1978,Felony,0,0,1,11,1,13
Essex,1978,Misdemeanor,0,0,0,6,7,13
Franklin,1978,Felony,0,2,1,7,2,12
Franklin,1978,Misdemeanor,0,0,3,16,14,33
Fulton,1978,Felony,1,1,0,0,1,3
Fulton,1978,Misdemeanor,0,0,3,27,13,43
Genesee,1978,Felony,0,3,6,13,4,26
Genesee,1978,Misdemeanor,0,1,1,25,25,52
Greene,1978,Felony,2,1,2,9,3,17
Greene,1978,Misdemeanor,0,0,3,24,12,39
Hamilton,1978,Felony,0,0,0,0,0,0
Hamilton,1978,Misdemeanor,0,0,0,3,1,4
Herkimer,1978,Felony,0,4,1,5,0,10
Herkimer,1978,Misdemeanor,0,0,0,17,3,20
Jefferson,1978,Felony,0,2,8,59,8,77
Jefferson,1978,Misdemeanor,0,6,4,36,14,60
Kings,1978,Felony,106,39,4,233,397,779
Kings,1978,Misdemeanor,0,48,24,1492,574,2138
Lewis,1978,Felony,0,0,0,3,0,3
Lewis,1978,Misdemeanor,0,0,0,13,1,14
Livingston,1978,Felony,2,1,5,13,5,26
Livingston,1978,Misdemeanor,0,0,2,19,24,45
Madison,1978,Felony,1,2,5,6,2,16
Madison,1978,Misdemeanor,0,3,5,20,15,43
Monroe,1978,Felony,15,37,42,116,49,259
Monroe,1978,Misdemeanor,0,17,16,426,124,583
Montgomery,1978,Felony,1,0,2,4,1,8
Montgomery,1978,Misdemeanor,0,3,4,17,6,30
Nassau,1978,Felony,21,62,32,155,92,362
Nassau,1978,Misdemeanor,0,37,183,710,250,1180
New York,1978,Felony,116,130,0,139,410,795
New York,1978,Misdemeanor,0,253,11,956,392,1612
Niagara,1978,Felony,4,3,2,18,7,34
Niagara,1978,Misdemeanor,0,8,9,107,52,176
Oneida,1978,Felony,8,2,31,84,13,138
Oneida,1978,Misdemeanor,0,4,6,61,40,111
Onondaga,1978,Felony,20,9,13,108,28,178
Onondaga,1978,Misdemeanor,0,2,44,145,70,261
Ontario,1978,Felony,14,1,26,47,17,105
Ontario,1978,Misdemeanor,0,3,8,20,12,43
Orange,1978,Felony,2,0,25,59,11,97
Orange,1978,Misdemeanor,0,8,23,149,82,262
Orleans,1978,Felony,0,0,10,18,4,32
Orleans,1978,Misdemeanor,0,0,3,10,10,23
Oswego,1978,Felony,2,1,5,51,5,64
Oswego,1978,Misdemeanor,0,2,4,39,14,59
Otsego,1978,Felony,0,0,4,7,0,11
Otsego,1978,Misdemeanor,0,0,0,17,3,20
Putnam,1978,Felony,0,0,2,11,4,17
Putnam,1978,Misdemeanor,0,0,1,27,8,36
Queens,1978,Felony,41,74,1,151,228,495
Queens,1978,Misdemeanor,0,90,5,739,261,1095
Rensselaer,1978,Felony,2,4,0,4,2,12
Rensselaer,1978,Misdemeanor,0,3,10,51,25,89
Richmond,1978,Felony,11,5,0,53,29,98
Richmond,1978,Misdemeanor,0,8,2,109,58,177
Rockland,1978,Felony,5,18,9,39,15,86
Rockland,1978,Misdemeanor,0,10,4,53,41,108
St. Lawrence,1978,Felony,0,1,2,10,5,18
St. Lawrence,1978,Misdemeanor,0,2,3,57,21,83
Saratoga,1978,Felony,2,0,1,4,4,11
Saratoga,1978,Misdemeanor,0,4,1,25,9,39
Schenectady,1978,Felony,1,0,0,11,2,14
Schenectady,1978,Misdemeanor,0,1,1,54,22,78
Schoharie,1978,Felony,2,0,0,5,0,7
Schoharie,1978,Misdemeanor,0,7,1,14,3,25
Schuyler,1978,Felony,0,0,2,4,0,6
Schuyler,1978,Misdemeanor,0,6,0,17,13,36
Seneca,1978,Felony,0,1,5,8,1,15
Seneca,1978,Misdemeanor,0,1,0,18,6,25
Steuben,1978,Felony,3,1,7,29,3,43
Steuben,1978,Misdemeanor,0,0,1,56,23,80
Suffolk,1978,Felony,24,43,10,223,105,405
Suffolk,1978,Misdemeanor,0,33,184,599,217,1033
Sullivan,1978,Felony,2,2,3,16,8,31
Sullivan,1978,Misdemeanor,0,1,8,42,12,63
Tioga,1978,Felony,3,1,2,20,2,28
Tioga,1978,Misdemeanor,0,0,1,10,2,13
Tompkins,1978,Felony,0,0,4,6,0,10
Tompkins,1978,Misdemeanor,0,2,4,39,17,62
Ulster,1978,Felony,6,4,0,21,8,39
Ulster,1978,Misdemeanor,0,1,1,27,14,43
Warren,1978,Felony,1,0,0,3,0,4
Warren,1978,Misdemeanor,0,2,1,25,13,41
Washington,1978,Felony,1,1,5,1,2,10
Washington,1978,Misdemeanor,0,2,7,11,9,29
Wayne,1978,Felony,0,0,1,4,0,5
Wayne,1978,Misdemeanor,0,0,7,20,5,32
Westchester,1978,Felony,17,19,62,105,37,240
Westchester,1978,Misdemeanor,0,35,14,434,235,718
Wyoming,1978,Felony,2,0,1,9,1,13
Wyoming,1978,Misdemeanor,0,0,0,10,8,18
Yates,1978,Felony,0,0,0,2,3,5
Yates,1978,Misdemeanor,0,0,0,8,0,8
Unknown,1978,Misdemeanor,0,0,0,0,0,0
Albany,1979,Felony,9,8,8,29,4,58
Albany,1979,Misdemeanor,0,28,93,326,163,610
Allegany,1979,Felony,3,0,8,14,4,29
Allegany,1979,Misdemeanor,0,1,2,29,5,37
Bronx,1979,Felony,167,52,0,120,224,563
Bronx,1979,Misdemeanor,0,36,13,711,366,1126
Broome,1979,Felony,16,1,13,86,12,128
Broome,1979,Misdemeanor,0,1,7,96,32,136
Cattaraugus,1979,Felony,1,2,6,21,3,33
Cattaraugus,1979,Misdemeanor,0,0,1,18,12,31
Cayuga,1979,Felony,3,0,0,8,2,13
Cayuga,1979,Misdemeanor,0,0,3,21,5,29
Chautauqua,1979,Felony,3,2,17,31,13,66
Chautauqua,1979,Misdemeanor,0,8,12,95,49,164
Chemung,1979,Felony,9,2,19,93,8,131
Chemung,1979,Misdemeanor,0,1,45,65,24,135
Chenango,1979,Felony,0,0,1,2,0,3
Chenango,1979,Misdemeanor,0,1,3,26,9,39
Clinton,1979,Felony,3,2,10,26,2,43
Clinton,1979,Misdemeanor,0,1,1,35,12,49
Columbia,1979,Felony,0,1,0,8,1,10
Columbia,1979,Misdemeanor,0,4,0,45,14,63
Cortland,1979,Felony,6,0,5,23,3,37
Cortland,1979,Misdemeanor,0,0,3,25,18,46
Delaware,1979,Felony,1,3,0,14,1,19
Delaware,1979,Misdemeanor,0,2,0,21,10,33
Dutchess,1979,Felony,3,0,1,58,15,77
Dutchess,1979,Misdemeanor,0,5,15,196,49,265
Erie,1979,Felony,34,34,42,40,42,192
Erie,1979,Misdemeanor,0,67,126,649,308,1150
Essex,1979,Felony,0,0,0,14,1,15
Essex,1979,Misdemeanor,0,0,0,9,2,11
Franklin,1979,Felony,1,2,4,6,0,13
Franklin,1979,Misdemeanor,0,0,2,36,12,50
Fulton,1979,Felony,1,0,1,7,2,11
Fulton,1979,Misdemeanor,0,4,3,50,13,70
Genesee,1979,Felony,0,0,8,6,1,15
Genesee,1979,Misdemeanor,0,2,4,34,21,61
Greene,1979,Felony,2,0,4,7,4,17
Greene,1979,Misdemeanor,0,0,1,25,11,37
Hamilton,1979,Felony,0,0,3,1,1,5
Hamilton,1979,Misdemeanor,0,0,0,3,2,5
Herkimer,1979,Felony,0,0,1,0,2,3
Herkimer,1979,Misdemeanor,0,1,1,14,14,30
Jefferson,1979,Felony,11,2,15,34,10,72
Jefferson,1979,Misdemeanor,0,7,13,36,18,74
Kings,1979,Felony,216,64,1,183,333,797
Kings,1979,Misdemeanor,0,56,16,1569,589,2230
Lewis,1979,Felony,0,0,1,6,1,8
Lewis,1979,Misdemeanor,0,0,0,12,5,17
Livingston,1979,Felony,5,3,7,26,2,43
Livingston,1979,Misdemeanor,0,4,7,47,22,80
Madison,1979,Felony,0,0,9,16,1,26
Madison,1979,Misdemeanor,0,0,11,29,17,57
Monroe,1979,Felony,29,25,77,104,65,300
Monroe,1979,Misdemeanor,0,12,34,433,139,618
Montgomery,1979,Felony,0,0,2,4,1,7
Montgomery,1979,Misdemeanor,0,0,1,15,10,26
Nassau,1979,Felony,90,89,21,241,82,523
Nassau,1979,Misdemeanor,0,69,277,1071,393,1810
New York,1979,Felony,227,123,1,170,336,857
New York,1979,Misdemeanor,0,259,5,835,378,1477
Niagara,1979,Felony,4,5,4,31,11,55
Niagara,1979,Misdemeanor,0,13,7,93,45,158
Oneida,1979,Felony,20,9,36,106,16,187
Oneida,1979,Misdemeanor,0,12,7,82,61,162
Onondaga,1979,Felony,36,17,23,115,35,226
Onondaga,1979,Misdemeanor,0,11,61,137,90,299
Ontario,1979,Felony,3,7,30,49,10,99
Ontario,1979,Misdemeanor,0,1,2,42,24,69
Orange,1979,Felony,5,6,29,49,18,107
Orange,1979,Misdemeanor,0,21,20,195,94,330
Orleans,1979,Felony,0,1,18,16,11,46
Orleans,1979,Misdemeanor,0,1,3,17,10,31
Oswego,1979,Felony,6,1,4,36,6,53
Oswego,1979,Misdemeanor,0,2,4,53,19,78
Otsego,1979,Felony,1,0,5,10,1,17
Otsego,1979,Misdemeanor,0,0,1,40,4,45
Putnam,1979,Felony,0,0,0,3,0,3
Putnam,1979,Misdemeanor,0,0,2,9,4,15
Queens,1979,Felony,98,64,0,108,150,420
Queens,1979,Misdemeanor,0,83,3,641,259,986
Rensselaer,1979,Felony,5,4,9,14,2,34
Rensselaer,1979,Misdemeanor,0,13,8,101,30,152
Richmond,1979,Felony,40,4,0,44,24,112
Richmond,1979,Misdemeanor,0,8,1,124,38,171
Rockland,1979,Felony,3,23,11,74,11,122
Rockland,1979,Misdemeanor,0,9,4,97,49,159
St. Lawrence,1979,Felony,0,4,2,6,2,14
St. Lawrence,1979,Misdemeanor,0,1,3,41,32,77
Saratoga,1979,Felony,2,1,0,7,0,10
Saratoga,1979,Misdemeanor,0,1,1,35,14,51
Schenectady,1979,Felony,4,2,2,20,5,33
Schenectady,1979,Misdemeanor,0,5,5,61,28,99
Schoharie,1979,Felony,0,0,0,2,0,2
Schoharie,1979,Misdemeanor,0,0,1,9,2,12
Schuyler,1979,Felony,0,0,1,4,1,6
Schuyler,1979,Misdemeanor,0,2,5,23,11,41
Seneca,1979,Felony,0,1,7,6,0,14
Seneca,1979,Misdemeanor,0,0,4,28,1,33
Steuben,1979,Felony,3,1,13,29,4,50
Steuben,1979,Misdemeanor,0,9,1,47,18,75
Suffolk,1979,Felony,86,59,15,187,92,439
Suffolk,1979,Misdemeanor,0,42,262,730,332,1366
Sullivan,1979,Felony,1,5,5,8,4,23
Sullivan,1979,Misdemeanor,0,2,9,38,18,67
Tioga,1979,Felony,3,0,5,12,0,20
Tioga,1979,Misdemeanor,0,1,0,9,4,14
Tompkins,1979,Felony,4,0,9,9,3,25
Tompkins,1979,Misdemeanor,0,2,11,72,24,109
Ulster,1979,Felony,2,3,0,23,2,30
Ulster,1979,Misdemeanor,0,1,0,33,11,45
Warren,1979,Felony,2,3,2,1,1,9
Warren,1979,Misdemeanor,0,4,2,44,31,81
Washington,1979,Felony,1,0,1,2,0,4
Washington,1979,Misdemeanor,0,0,4,9,15,28
Wayne,1979,Felony,0,0,1,4,1,6
Wayne,1979,Misdemeanor,0,3,2,26,10,41
Westchester,1979,Felony,41,18,65,130,55,309
Westchester,1979,Misdemeanor,0,68,12,468,239,787
Wyoming,1979,Felony,0,0,0,6,1,7
Wyoming,1979,Misdemeanor,0,0,1,15,10,26
Yates,1979,Felony,0,0,0,3,0,3
Yates,1979,Misdemeanor,0,0,1,13,2,16
Unknown,1979,Misdemeanor,0,0,0,0,0,0
Albany,1980,Felony,13,9,7,24,13,66
Albany,1980,Misdemeanor,0,38,91,291,210,630
Allegany,1980,Felony,1,0,7,8,2,18
Allegany,1980,Misdemeanor,0,1,1,25,6,33
Bronx,1980,Felony,178,142,0,187,170,677
Bronx,1980,Misdemeanor,0,69,9,679,353,1110
Broome,1980,Felony,15,4,29,82,26,156
Broome,1980,Misdemeanor,0,0,1,70,37,108
Cattaraugus,1980,Felony,0,1,12,28,2,43
Cattaraugus,1980,Misdemeanor,0,2,0,27,7,36
Cayuga,1980,Felony,0,0,1,3,0,4
Cayuga,1980,Misdemeanor,0,1,3,29,6,39
Chautauqua,1980,Felony,1,3,7,28,4,43
Chautauqua,1980,Misdemeanor,0,6,12,74,37,129
Chemung,1980,Felony,19,7,16,68,22,132
Chemung,1980,Misdemeanor,0,0,37,63,35,135
Chenango,1980,Felony,0,0,2,2,0,4
Chenango,1980,Misdemeanor,0,1,4,46,18,69
Clinton,1980,Felony,2,1,13,26,3,45
Clinton,1980,Misdemeanor,0,4,6,56,19,85
Columbia,1980,Felony,0,3,0,7,0,10
Columbia,1980,Misdemeanor,0,5,2,44,14,65
Cortland,1980,Felony,8,6,8,15,4,41
Cortland,1980,Misdemeanor,0,1,5,43,23,72
Delaware,1980,Felony,3,0,0,7,1,11
Delaware,1980,Misdemeanor,0,4,0,13,7,24
Dutchess,1980,Felony,7,9,1,54,13,84
Dutchess,1980,Misdemeanor,0,15,27,182,59,283
Erie,1980,Felony,41,38,39,34,28,180
Erie,1980,Misdemeanor,0,62,117,715,382,1276
Essex,1980,Felony,0,1,1,9,2,13
Essex,1980,Misdemeanor,0,0,3,26,12,41
Franklin,1980,Felony,1,0,0,14,5,20
Franklin,1980,Misdemeanor,0,1,0,35,5,41
Fulton,1980,Felony,3,0,1,6,0,10
Fulton,1980,Misdemeanor,0,0,3,46,16,65
Genesee,1980,Felony,3,2,3,7,3,18
Genesee,1980,Misdemeanor,0,0,9,39,21,69
Greene,1980,Felony,4,0,4,6,2,16
Greene,1980,Misdemeanor,0,0,0,34,7,41
Hamilton,1980,Felony,0,0,1,4,1,6
Hamilton,1980,Misdemeanor,0,0,0,3,0,3
Herkimer,1980,Felony,0,0,0,2,2,4
Herkimer,1980,Misdemeanor,0,1,2,23,7,33
Jefferson,1980,Felony,7,0,14,29,10,60
Jefferson,1980,Misdemeanor,0,3,23,41,27,94
Kings,1980,Felony,440,71,1,176,250,938
Kings,1980,Misdemeanor,0,70,17,1760,612,2459
Lewis,1980,Felony,0,2,0,2,1,5
Lewis,1980,Misdemeanor,0,0,6,29,6,41
Livingston,1980,Felony,2,1,7,23,5,38
Livingston,1980,Misdemeanor,0,3,8,46,23,80
Madison,1980,Felony,2,0,14,22,1,39
Madison,1980,Misdemeanor,0,0,14,37,10,61
Monroe,1980,Felony,17,21,70,77,63,248
Monroe,1980,Misdemeanor,0,11,63,410,149,633
Montgomery,1980,Felony,1,0,1,6,2,10
Montgomery,1980,Misdemeanor,0,3,6,16,9,34
Nassau,1980,Felony,91,114,33,222,88,548
Nassau,1980,Misdemeanor,0,116,250,1143,372,1881
New York,1980,Felony,317,148,0,210,333,1008
New York,1980,Misdemeanor,0,299,7,1046,291,1643
Niagara,1980,Felony,8,3,7,27,11,56
Niagara,1980,Misdemeanor,0,15,9,130,64,218
Oneida,1980,Felony,18,5,51,98,23,195
Oneida,1980,Misdemeanor,0,8,9,94,55,166
Onondaga,1980,Felony,31,21,22,167,60,301
Onondaga,1980,Misdemeanor,0,7,79,159,87,332
Ontario,1980,Felony,6,3,39,42,6,96
Ontario,1980,Misdemeanor,0,0,7,39,37,83
Orange,1980,Felony,4,7,12,69,22,114
Orange,1980,Misdemeanor,0,14,41,194,97,346
Orleans,1980,Felony,2,0,10,24,6,42
Orleans,1980,Misdemeanor,0,2,5,23,23,53
Oswego,1980,Felony,7,10,10,26,7,60
Oswego,1980,Misdemeanor,0,0,6,52,19,77
Otsego,1980,Felony,0,0,12,17,2,31
Otsego,1980,Misdemeanor,0,2,2,26,7,37
Putnam,1980,Felony,2,0,0,0,2,4
Putnam,1980,Misdemeanor,0,0,1,14,3,18
Queens,1980,Felony,172,87,0,142,136,537
Queens,1980,Misdemeanor,0,167,17,992,341,1517
Rensselaer,1980,Felony,5,2,8,23,4,42
Rensselaer,1980,Misdemeanor,0,2,10,90,40,142
Richmond,1980,Felony,13,11,0,53,14,91
Richmond,1980,Misdemeanor,0,4,4,178,53,239
Rockland,1980,Felony,8,18,20,56,11,113
Rockland,1980,Misdemeanor,0,25,7,106,71,209
St. Lawrence,1980,Felony,2,0,5,9,3,19
St. Lawrence,1980,Misdemeanor,0,2,8,56,25,91
Saratoga,1980,Felony,1,0,2,4,0,7
Saratoga,1980,Misdemeanor,0,1,2,32,21,56
Schenectady,1980,Felony,9,3,1,26,2,41
Schenectady,1980,Misdemeanor,0,10,13,78,36,137
Schoharie,1980,Felony,0,0,0,3,0,3
Schoharie,1980,Misdemeanor,0,2,1,20,8,31
Schuyler,1980,Felony,0,0,2,3,0,5
Schuyler,1980,Misdemeanor,0,2,2,32,16,52
Seneca,1980,Felony,2,0,11,3,1,17
Seneca,1980,Misdemeanor,0,1,1,17,6,25
Steuben,1980,Felony,7,1,10,25,10,53
Steuben,1980,Misdemeanor,0,0,10,38,27,75
Suffolk,1980,Felony,94,47,5,151,71,368
Suffolk,1980,Misdemeanor,0,53,176,859,313,1401
Sullivan,1980,Felony,4,11,6,25,6,52
Sullivan,1980,Misdemeanor,0,7,18,47,18,90
Tioga,1980,Felony,0,3,6,16,5,30
Tioga,1980,Misdemeanor,0,0,3,16,6,25
Tompkins,1980,Felony,9,0,7,7,7,30
Tompkins,1980,Misdemeanor,0,0,10,46,23,79
Ulster,1980,Felony,0,5,1,33,10,49
Ulster,1980,Misdemeanor,0,1,2,43,21,67
Warren,1980,Felony,0,8,1,3,2,14
Warren,1980,Misdemeanor,0,1,4,31,24,60
Washington,1980,Felony,0,0,4,3,0,7
Washington,1980,Misdemeanor,0,1,13,15,7,36
Wayne,1980,Felony,1,1,8,21,5,36
Wayne,1980,Misdemeanor,0,1,6,20,21,48
Westchester,1980,Felony,39,21,62,117,54,293
Westchester,1980,Misdemeanor,0,94,19,620,252,985
Wyoming,1980,Felony,2,1,1,3,2,9
Wyoming,1980,Misdemeanor,0,1,0,23,4,28
Yates,1980,Felony,0,0,0,4,1,5
Yates,1980,Misdemeanor,0,0,0,10,6,16
Unknown,1980,Misdemeanor,0,0,0,0,0,0
Albany,1981,Felony,5,10,11,27,18,71
Albany,1981,Misdemeanor,0,64,98,371,218,751
Allegany,1981,Felony,1,1,7,17,0,26
Allegany,1981,Misdemeanor,0,2,10,22,6,40
Bronx,1981,Felony,277,182,0,191,196,846
Bronx,1981,Misdemeanor,0,62,10,736,291,1099
Broome,1981,Felony,10,11,36,60,11,128
Broome,1981,Misdemeanor,0,3,2,70,36,111
Cattaraugus,1981,Felony,2,1,12,29,11,55
Cattaraugus,1981,Misdemeanor,0,0,0,11,9,20
Cayuga,1981,Felony,1,0,0,16,0,17
Cayuga,1981,Misdemeanor,0,2,3,10,7,22
Chautauqua,1981,Felony,4,2,7,28,4,45
Chautauqua,1981,Misdemeanor,0,4,4,87,38,133
Chemung,1981,Felony,16,6,17,64,9,112
Chemung,1981,Misdemeanor,0,4,34,68,34,140
Chenango,1981,Felony,0,0,2,3,0,5
Chenango,1981,Misdemeanor,0,1,5,35,11,52
Clinton,1981,Felony,2,3,13,20,5,43
Clinton,1981,Misdemeanor,0,1,7,43,23,74
Columbia,1981,Felony,0,1,3,2,1,7
Columbia,1981,Misdemeanor,0,3,2,37,19,61
Cortland,1981,Felony,0,3,4,17,7,31
Cortland,1981,Misdemeanor,0,4,9,27,24,64
Delaware,1981,Felony,2,0,0,8,2,12
Delaware,1981,Misdemeanor,0,2,1,17,11,31
Dutchess,1981,Felony,2,5,0,57,15,79
Dutchess,1981,Misdemeanor,0,7,46,169,56,278
Erie,1981,Felony,32,17,43,65,29,186
Erie,1981,Misdemeanor,0,57,154,809,398,1418
Essex,1981,Felony,1,1,1,12,1,16
Essex,1981,Misdemeanor,0,1,1,12,3,17
Franklin,1981,Felony,5,2,0,17,1,25
Franklin,1981,Misdemeanor,0,1,2,33,11,47
Fulton,1981,Felony,3,2,2,7,6,20
Fulton,1981,Misdemeanor,0,8,1,40,23,72
Genesee,1981,Felony,5,1,6,10,3,25
Genesee,1981,Misdemeanor,0,0,23,46,29,98
Greene,1981,Felony,3,1,3,8,2,17
Greene,1981,Misdemeanor,0,3,0,15,8,26
Hamilton,1981,Felony,0,0,4,9,2,15
Hamilton,1981,Misdemeanor,0,0,1,0,2,3
Herkimer,1981,Felony,1,0,0,1,1,3
Herkimer,1981,Misdemeanor,0,0,1,19,8,28
Jefferson,1981,Felony,6,1,15,28,9,59
Jefferson,1981,Misdemeanor,0,1,6,38,21,66
Kings,1981,Felony,590,109,2,232,290,1223
Kings,1981,Misdemeanor,0,67,21,1790,503,2381
Lewis,1981,Felony,0,0,1,6,0,7
Lewis,1981,Misdemeanor,0,2,2,9,4,17
Livingston,1981,Felony,4,2,9,27,2,44
Livingston,1981,Misdemeanor,0,2,12,40,36,90
Madison,1981,Felony,1,6,13,11,1,32
Madison,1981,Misdemeanor,0,3,19,27,15,64
Monroe,1981,Felony,20,23,148,116,64,371
Monroe,1981,Misdemeanor,0,14,114,489,176,793
Montgomery,1981,Felony,1,0,2,3,2,8
Montgomery,1981,Misdemeanor,0,3,4,25,15,47
Nassau,1981,Felony,127,120,30,253,56,586
Nassau,1981,Misdemeanor,0,126,338,1019,428,1911
New York,1981,Felony,536,258,0,331,338,1463
New York,1981,Misdemeanor,0,433,20,1235,384,2072
Niagara,1981,Felony,6,3,0,19,7,35
Niagara,1981,Misdemeanor,0,5,32,157,70,264
Oneida,1981,Felony,22,15,37,84,13,171
Oneida,1981,Misdemeanor,0,10,14,80,35,139
Onondaga,1981,Felony,46,35,26,142,58,307
Onondaga,1981,Misdemeanor,0,16,132,162,94,404
Ontario,1981,Felony,7,3,44,38,6,98
Ontario,1981,Misdemeanor,0,3,9,55,28,95
Orange,1981,Felony,6,2,6,85,14,113
Orange,1981,Misdemeanor,0,7,42,161,74,284
Orleans,1981,Felony,5,8,18,20,6,57
Orleans,1981,Misdemeanor,0,3,5,26,17,51
Oswego,1981,Felony,8,5,13,52,5,83
Oswego,1981,Misdemeanor,0,1,11,39,19,70
Otsego,1981,Felony,3,0,8,17,1,29
Otsego,1981,Misdemeanor,0,2,3,18,3,26
Putnam,1981,Felony,2,1,1,8,1,13
Putnam,1981,Misdemeanor,0,3,9,24,6,42
Queens,1981,Felony,247,135,1,279,148,810
Queens,1981,Misdemeanor,0,154,18,933,293,1398
Rensselaer,1981,Felony,13,1,9,29,4,56
Rensselaer,1981,Misdemeanor,0,13,23,66,37,139
Richmond,1981,Felony,26,7,0,57,23,113
Richmond,1981,Misdemeanor,0,17,7,199,59,282
Rockland,1981,Felony,4,10,29,101,11,155
Rockland,1981,Misdemeanor,0,7,11,68,36,122
St. Lawrence,1981,Felony,2,2,9,14,2,29
St. Lawrence,1981,Misdemeanor,0,3,12,54,13,82
Saratoga,1981,Felony,6,5,2,2,2,17
Saratoga,1981,Misdemeanor,0,4,5,56,22,87
Schenectady,1981,Felony,11,5,2,38,4,60
Schenectady,1981,Misdemeanor,0,2,13,65,24,104
Schoharie,1981,Felony,0,0,0,1,0,1
Schoharie,1981,Misdemeanor,0,1,3,18,4,26
Schuyler,1981,Felony,0,0,1,3,0,4
Schuyler,1981,Misdemeanor,0,0,3,15,18,36
Seneca,1981,Felony,1,0,16,1,0,18
Seneca,1981,Misdemeanor,0,0,0,24,14,38
Steuben,1981,Felony,5,0,12,24,1,42
Steuben,1981,Misdemeanor,0,2,5,42,22,71
Suffolk,1981,Felony,108,79,30,290,63,570
Suffolk,1981,Misdemeanor,0,61,801,959,352,2173
Sullivan,1981,Felony,6,5,5,22,10,48
Sullivan,1981,Misdemeanor,0,0,20,40,7,67
Tioga,1981,Felony,1,1,13,14,4,33
Tioga,1981,Misdemeanor,0,0,2,19,6,27
Tompkins,1981,Felony,1,3,9,18,2,33
Tompkins,1981,Misdemeanor,0,2,4,34,10,50
Ulster,1981,Felony,1,3,0,28,4,36
Ulster,1981,Misdemeanor,0,3,3,34,26,66
Warren,1981,Felony,0,3,0,2,3,8
Warren,1981,Misdemeanor,0,0,3,64,23,90
Washington,1981,Felony,0,0,2,11,0,13
Washington,1981,Misdemeanor,0,0,8,25,5,38
Wayne,1981,Felony,5,2,12,29,7,55
Wayne,1981,Misdemeanor,0,2,12,44,13,71
Westchester,1981,Felony,62,43,55,165,40,365
Westchester,1981,Misdemeanor,0,111,31,571,251,964
Wyoming,1981,Felony,1,0,1,10,5,17
Wyoming,1981,Misdemeanor,0,0,1,22,6,29
Yates,1981,Felony,2,0,0,2,1,5
Yates,1981,Misdemeanor,0,0,0,10,3,13
Unknown,1981,Misdemeanor,0,0,0,0,0,0
Albany,1982,Felony,13,9,20,20,14,76
Albany,1982,Misdemeanor,0,44,81,344,211,680
Allegany,1982,Felony,0,0,14,10,4,28
Allegany,1982,Misdemeanor,0,1,5,17,6,29
Bronx,1982,Felony,372,300,0,115,268,1055
Bronx,1982,Misdemeanor,0,41,10,400,155,606
Broome,1982,Felony,27,9,36,56,15,143
Broome,1982,Misdemeanor,0,6,8,57,36,107
Cattaraugus,1982,Felony,2,2,8,26,1,39
Cattaraugus,1982,Misdemeanor,0,0,2,17,2,21
Cayuga,1982,Felony,2,4,0,12,2,20
Cayuga,1982,Misdemeanor,0,1,3,13,9,26
Chautauqua,1982,Felony,5,6,2,24,6,43
Chautauqua,1982,Misdemeanor,0,2,6,75,33,116
Chemung,1982,Felony,26,3,19,43,37,128
Chemung,1982,Misdemeanor,0,0,42,44,32,118
Chenango,1982,Felony,2,0,3,1,0,6
Chenango,1982,Misdemeanor,0,2,2,38,21,63
Clinton,1982,Felony,6,17,23,25,5,76
Clinton,1982,Misdemeanor,0,1,6,31,7,45
Columbia,1982,Felony,1,5,3,4,2,15
Columbia,1982,Misdemeanor,0,4,3,38,13,58
Cortland,1982,Felony,1,0,11,6,7,25
Cortland,1982,Misdemeanor,0,2,6,35,27,70
Delaware,1982,Felony,9,2,0,3,5,19
Delaware,1982,Misdemeanor,0,1,4,33,13,51
Dutchess,1982,Felony,4,8,13,29,4,58
Dutchess,1982,Misdemeanor,0,12,55,139,53,259
Erie,1982,Felony,52,19,59,59,29,218
Erie,1982,Misdemeanor,0,69,181,696,461,1407
Essex,1982,Felony,1,2,1,13,1,18
Essex,1982,Misdemeanor,0,0,4,7,5,16
Franklin,1982,Felony,1,3,0,4,3,11
Franklin,1982,Misdemeanor,0,1,3,29,11,44
Fulton,1982,Felony,3,0,3,3,2,11
Fulton,1982,Misdemeanor,0,3,2,42,12,59
Genesee,1982,Felony,1,5,12,7,7,32
Genesee,1982,Misdemeanor,0,3,33,59,39,134
Greene,1982,Felony,2,1,1,4,4,12
Greene,1982,Misdemeanor,0,3,0,16,6,25
Hamilton,1982,Felony,0,0,1,3,2,6
Hamilton,1982,Misdemeanor,0,0,0,3,0,3
Herkimer,1982,Felony,0,1,3,2,0,6
Herkimer,1982,Misdemeanor,0,1,5,21,7,34
Jefferson,1982,Felony,23,6,16,29,5,79
Jefferson,1982,Misdemeanor,0,10,16,52,33,111
Kings,1982,Felony,607,221,1,172,459,1460
Kings,1982,Misdemeanor,0,73,8,1282,448,1811
Lewis,1982,Felony,0,0,1,6,2,9
Lewis,1982,Misdemeanor,0,2,6,16,3,27
Livingston,1982,Felony,12,0,12,21,5,50
Livingston,1982,Misdemeanor,0,2,9,45,34,90
Madison,1982,Felony,2,4,11,19,3,39
Madison,1982,Misdemeanor,0,2,14,19,14,49
Monroe,1982,Felony,18,16,156,112,44,346
Monroe,1982,Misdemeanor,0,16,130,477,198,821
Montgomery,1982,Felony,0,1,6,12,1,20
Montgomery,1982,Misdemeanor,0,1,4,12,8,25
Nassau,1982,Felony,203,118,23,156,67,567
Nassau,1982,Misdemeanor,0,133,420,1091,475,2119
New York,1982,Felony,680,375,0,330,418,1803
New York,1982,Misdemeanor,0,495,12,1215,368,2090
Niagara,1982,Felony,4,0,3,14,7,28
Niagara,1982,Misdemeanor,0,9,41,152,70,272
Oneida,1982,Felony,39,10,42,42,13,146
Oneida,1982,Misdemeanor,0,11,21,114,62,208
Onondaga,1982,Felony,51,58,42,154,68,373
Onondaga,1982,Misdemeanor,0,20,116,158,122,416
Ontario,1982,Felony,11,3,38,29,7,88
Ontario,1982,Misdemeanor,0,2,8,42,18,70
Orange,1982,Felony,28,18,20,39,19,124
Orange,1982,Misdemeanor,0,14,70,161,77,322
Orleans,1982,Felony,4,5,5,18,6,38
Orleans,1982,Misdemeanor,0,1,2,23,14,40
Oswego,1982,Felony,7,2,11,25,1,46
Oswego,1982,Misdemeanor,0,2,11,35,21,69
Otsego,1982,Felony,15,6,8,17,13,59
Otsego,1982,Misdemeanor,0,2,5,17,13,37
Putnam,1982,Felony,2,3,4,2,4,15
Putnam,1982,Misdemeanor,0,2,11,15,2,30
Queens,1982,Felony,233,94,2,174,178,681
Queens,1982,Misdemeanor,0,96,13,601,272,982
Rensselaer,1982,Felony,6,6,17,22,12,63
Rensselaer,1982,Misdemeanor,0,6,18,102,47,173
Richmond,1982,Felony,59,5,0,41,21,126
Richmond,1982,Misdemeanor,0,10,1,128,45,184
Rockland,1982,Felony,9,24,28,62,12,135
Rockland,1982,Misdemeanor,0,7,8,61,32,108
St. Lawrence,1982,Felony,6,11,11,6,2,36
St. Lawrence,1982,Misdemeanor,0,5,20,47,29,101
Saratoga,1982,Felony,4,0,4,2,4,14
Saratoga,1982,Misdemeanor,0,0,6,37,19,62
Schenectady,1982,Felony,20,2,10,20,4,56
Schenectady,1982,Misdemeanor,0,3,14,75,45,137
Schoharie,1982,Felony,3,6,0,4,1,14
Schoharie,1982,Misdemeanor,0,1,1,10,7,19
Schuyler,1982,Felony,0,0,5,2,0,7
Schuyler,1982,Misdemeanor,0,0,2,20,15,37
Seneca,1982,Felony,0,0,15,3,0,18
Seneca,1982,Misdemeanor,0,2,2,10,2,16
Steuben,1982,Felony,5,0,5,13,2,25
Steuben,1982,Misdemeanor,0,2,4,55,26,87
Suffolk,1982,Felony,231,112,94,243,100,780
Suffolk,1982,Misdemeanor,0,58,981,663,369,2071
Sullivan,1982,Felony,7,11,31,33,4,86
Sullivan,1982,Misdemeanor,0,2,33,58,30,123
Tioga,1982,Felony,8,2,5,22,4,41
Tioga,1982,Misdemeanor,0,2,5,13,13,33
Tompkins,1982,Felony,8,6,9,11,3,37
Tompkins,1982,Misdemeanor,0,0,6,33,12,51
Ulster,1982,Felony,7,7,12,62,4,92
Ulster,1982,Misdemeanor,0,1,8,37,25,71
Warren,1982,Felony,0,1,2,4,2,9
Warren,1982,Misdemeanor,0,7,9,35,18,69
Washington,1982,Felony,2,3,0,4,1,10
Washington,1982,Misdemeanor,0,2,13,18,11,44
Wayne,1982,Felony,6,1,15,16,4,42
Wayne,1982,Misdemeanor,0,6,11,31,6,54
Westchester,1982,Felony,120,32,112,106,72,442
Westchester,1982,Misdemeanor,0,118,29,499,276,922
Wyoming,1982,Felony,0,0,4,3,0,7
Wyoming,1982,Misdemeanor,0,1,2,11,7,21
Yates,1982,Felony,3,0,0,4,1,8
Yates,1982,Misdemeanor,0,0,1,6,4,11
Unknown,1982,Misdemeanor,0,0,0,1,0,1
Albany,1983,Felony,16,23,35,24,21,119
Albany,1983,Misdemeanor,0,37,86,309,252,684
Allegany,1983,Felony,0,0,5,11,5,21
Allegany,1983,Misdemeanor,0,0,1,28,17,46
Bronx,1983,Felony,493,402,0,139,406,1440
Bronx,1983,Misdemeanor,0,61,16,363,291,731
Broome,1983,Felony,32,10,26,37,20,125
Broome,1983,Misdemeanor,0,2,30,87,55,174
Cattaraugus,1983,Felony,3,5,18,17,7,50
Cattaraugus,1983,Misdemeanor,0,1,2,13,4,20
Cayuga,1983,Felony,0,0,1,23,3,27
Cayuga,1983,Misdemeanor,0,1,3,15,13,32
Chautauqua,1983,Felony,8,5,7,14,6,40
Chautauqua,1983,Misdemeanor,0,2,5,81,34,122
Chemung,1983,Felony,26,11,31,53,25,146
Chemung,1983,Misdemeanor,0,3,32,63,19,117
Chenango,1983,Felony,0,0,3,0,4,7
Chenango,1983,Misdemeanor,0,1,6,35,27,69
Clinton,1983,Felony,3,3,16,22,6,50
Clinton,1983,Misdemeanor,0,0,7,52,13,72
Columbia,1983,Felony,2,1,6,4,3,16
Columbia,1983,Misdemeanor,0,8,6,45,22,81
Cortland,1983,Felony,7,2,13,22,8,52
Cortland,1983,Misdemeanor,0,0,7,42,24,73
Delaware,1983,Felony,5,1,0,7,3,16
Delaware,1983,Misdemeanor,0,1,6,16,13,36
Dutchess,1983,Felony,7,22,28,70,16,143
Dutchess,1983,Misdemeanor,0,13,47,158,62,280
Erie,1983,Felony,68,29,111,92,58,358
Erie,1983,Misdemeanor,0,101,223,728,476,1528
Essex,1983,Felony,0,2,4,18,1,25
Essex,1983,Misdemeanor,0,1,4,12,7,24
Franklin,1983,Felony,7,0,3,9,1,20
Franklin,1983,Misdemeanor,0,0,3,37,19,59
Fulton,1983,Felony,5,1,1,8,2,17
Fulton,1983,Misdemeanor,0,0,5,44,22,71
Genesee,1983,Felony,13,6,13,18,3,53
Genesee,1983,Misdemeanor,0,5,46,41,38,130
Greene,1983,Felony,2,3,4,5,3,17
Greene,1983,Misdemeanor,0,0,2,45,18,65
Hamilton,1983,Felony,0,0,1,3,0,4
Hamilton,1983,Misdemeanor,0,2,0,2,0,4
Herkimer,1983,Felony,3,0,2,6,1,12
Herkimer,1983,Misdemeanor,0,1,3,26,13,43
Jefferson,1983,Felony,15,7,16,27,16,81
Jefferson,1983,Misdemeanor,0,5,18,42,32,97
Kings,1983,Felony,892,357,3,299,595,2146
Kings,1983,Misdemeanor,0,69,13,1233,553,1868
Lewis,1983,Felony,0,0,2,1,2,5
Lewis,1983,Misdemeanor,0,0,2,11,6,19
Livingston,1983,Felony,18,0,19,19,6,62
Livingston,1983,Misdemeanor,0,1,18,24,30,73
Madison,1983,Felony,9,2,21,35,7,74
Madison,1983,Misdemeanor,0,1,21,37,15,74
Monroe,1983,Felony,33,26,146,121,48,374
Monroe,1983,Misdemeanor,0,31,166,512,192,901
Montgomery,1983,Felony,1,1,16,17,5,40
Montgomery,1983,Misdemeanor,0,7,5,14,6,32
Nassau,1983,Felony,168,112,86,134,70,570
Nassau,1983,Misdemeanor,0,128,470,954,487,2039
New York,1983,Felony,775,543,0,426,436,2180
New York,1983,Misdemeanor,0,663,13,1206,401,2283
Niagara,1983,Felony,8,4,7,22,9,50
Niagara,1983,Misdemeanor,0,8,56,162,72,298
Oneida,1983,Felony,35,10,67,54,24,190
Oneida,1983,Misdemeanor,0,7,15,129,81,232
Onondaga,1983,Felony,63,45,48,170,77,403
Onondaga,1983,Misdemeanor,0,10,243,120,120,493
Ontario,1983,Felony,11,1,44,26,9,91
Ontario,1983,Misdemeanor,0,3,14,50,24,91
Orange,1983,Felony,25,19,13,37,21,115
Orange,1983,Misdemeanor,0,15,90,187,76,368
Orleans,1983,Felony,10,0,15,14,9,48
Orleans,1983,Misdemeanor,0,4,9,19,15,47
Oswego,1983,Felony,18,8,9,57,7,99
Oswego,1983,Misdemeanor,0,1,17,30,22,70
Otsego,1983,Felony,6,3,15,18,4,46
Otsego,1983,Misdemeanor,0,0,8,18,6,32
Putnam,1983,Felony,0,5,0,2,1,8
Putnam,1983,Misdemeanor,0,4,15,20,12,51
Queens,1983,Felony,334,195,6,263,266,1064
Queens,1983,Misdemeanor,0,92,43,598,310,1043
Rensselaer,1983,Felony,1,3,16,12,2,34
Rensselaer,1983,Misdemeanor,0,6,22,79,40,147
Richmond,1983,Felony,38,20,3,26,35,122
Richmond,1983,Misdemeanor,0,9,5,131,48,193
Rockland,1983,Felony,26,33,34,63,28,184
Rockland,1983,Misdemeanor,0,10,14,47,39,110
St. Lawrence,1983,Felony,6,5,13,19,8,51
St. Lawrence,1983,Misdemeanor,0,2,33,49,24,108
Saratoga,1983,Felony,1,10,4,5,3,23
Saratoga,1983,Misdemeanor,0,5,19,51,18,93
Schenectady,1983,Felony,23,3,9,30,15,80
Schenectady,1983,Misdemeanor,0,6,27,78,56,167
Schoharie,1983,Felony,1,0,4,5,0,10
Schoharie,1983,Misdemeanor,0,0,1,18,12,31
Schuyler,1983,Felony,0,0,6,2,0,8
Schuyler,1983,Misdemeanor,0,1,13,24,23,61
Seneca,1983,Felony,1,2,13,4,2,22
Seneca,1983,Misdemeanor,0,0,11,16,3,30
Steuben,1983,Felony,3,3,20,23,2,51
Steuben,1983,Misdemeanor,0,2,11,45,33,91
Suffolk,1983,Felony,260,112,108,205,96,781
Suffolk,1983,Misdemeanor,0,67,827,607,349,1850
Sullivan,1983,Felony,5,9,41,40,8,103
Sullivan,1983,Misdemeanor,0,2,40,59,30,131
Tioga,1983,Felony,8,3,9,14,2,36
Tioga,1983,Misdemeanor,0,6,4,17,8,35
Tompkins,1983,Felony,15,2,20,22,7,66
Tompkins,1983,Misdemeanor,0,2,19,27,17,65
Ulster,1983,Felony,15,5,19,51,9,99
Ulster,1983,Misdemeanor,0,7,10,37,27,81
Warren,1983,Felony,4,0,6,6,0,16
Warren,1983,Misdemeanor,0,6,4,29,16,55
Washington,1983,Felony,2,0,16,2,7,27
Washington,1983,Misdemeanor,0,0,14,30,10,54
Wayne,1983,Felony,14,3,29,28,2,76
Wayne,1983,Misdemeanor,0,0,22,27,24,73
Westchester,1983,Felony,131,47,123,142,73,516
Westchester,1983,Misdemeanor,0,131,24,423,269,847
Wyoming,1983,Felony,2,2,4,4,2,14
Wyoming,1983,Misdemeanor,0,5,4,15,11,35
Yates,1983,Felony,1,1,3,7,2,14
Yates,1983,Misdemeanor,0,0,1,11,7,19
Unknown,1983,Misdemeanor,0,0,0,0,0,0
Albany,1984,Felony,13,8,15,19,13,68
Albany,1984,Misdemeanor,0,47,67,316,242,672
Allegany,1984,Felony,2,0,12,13,3,30
Allegany,1984,Misdemeanor,0,5,12,29,7,53
Bronx,1984,Felony,518,283,5,140,317,1263
Bronx,1984,Misdemeanor,0,94,19,477,334,924
Broome,1984,Felony,34,12,36,50,34,166
Broome,1984,Misdemeanor,0,5,26,96,68,195
Cattaraugus,1984,Felony,4,4,13,20,7,48
Cattaraugus,1984,Misdemeanor,0,0,3,12,9,24
Cayuga,1984,Felony,0,0,4,3,3,10
Cayuga,1984,Misdemeanor,0,0,7,25,16,48
Chautauqua,1984,Felony,7,2,5,15,12,41
Chautauqua,1984,Misdemeanor,0,1,8,71,55,135
Chemung,1984,Felony,27,4,27,37,13,108
Chemung,1984,Misdemeanor,0,3,21,62,44,130
Chenango,1984,Felony,1,0,5,2,0,8
Chenango,1984,Misdemeanor,0,1,21,23,27,72
Clinton,1984,Felony,8,3,11,24,4,50
Clinton,1984,Misdemeanor,0,3,17,38,25,83
Columbia,1984,Felony,0,2,8,0,1,11
Columbia,1984,Misdemeanor,0,2,3,31,23,59
Cortland,1984,Felony,11,1,13,11,10,46
Cortland,1984,Misdemeanor,0,2,12,36,22,72
Delaware,1984,Felony,5,3,0,7,1,16
Delaware,1984,Misdemeanor,0,0,3,30,10,43
Dutchess,1984,Felony,10,10,53,77,16,166
Dutchess,1984,Misdemeanor,0,12,76,144,58,290
Erie,1984,Felony,54,28,126,85,66,359
Erie,1984,Misdemeanor,0,81,227,599,461,1368
Essex,1984,Felony,1,1,0,11,2,15
Essex,1984,Misdemeanor,0,0,3,13,5,21
Franklin,1984,Felony,9,0,2,10,3,24
Franklin,1984,Misdemeanor,0,3,5,27,15,50
Fulton,1984,Felony,10,11,10,11,1,43
Fulton,1984,Misdemeanor,0,15,7,26,20,68
Genesee,1984,Felony,8,3,10,18,3,42
Genesee,1984,Misdemeanor,0,3,35,38,27,103
Greene,1984,Felony,3,4,2,8,2,19
Greene,1984,Misdemeanor,0,0,5,32,5,42
Hamilton,1984,Felony,0,0,0,0,0,0
Hamilton,1984,Misdemeanor,0,1,0,0,1,2
Herkimer,1984,Felony,1,2,2,9,1,15
Herkimer,1984,Misdemeanor,0,0,3,22,11,36
Jefferson,1984,Felony,21,3,12,20,12,68
Jefferson,1984,Misdemeanor,0,1,23,48,26,98
Kings,1984,Felony,752,337,5,301,589,1984
Kings,1984,Misdemeanor,0,82,28,1162,589,1861
Lewis,1984,Felony,0,0,2,3,3,8
Lewis,1984,Misdemeanor,0,0,7,5,2,14
Livingston,1984,Felony,6,3,17,23,6,55
Livingston,1984,Misdemeanor,0,0,26,19,29,74
Madison,1984,Felony,7,1,26,36,5,75
Madison,1984,Misdemeanor,0,0,12,32,14,58
Monroe,1984,Felony,54,35,101,111,73,374
Monroe,1984,Misdemeanor,0,18,236,351,219,824
Montgomery,1984,Felony,1,2,24,41,6,74
Montgomery,1984,Misdemeanor,0,3,12,19,14,48
Nassau,1984,Felony,179,121,95,134,72,601
Nassau,1984,Misdemeanor,0,123,519,899,500,2041
New York,1984,Felony,702,595,4,484,477,2262
New York,1984,Misdemeanor,0,558,30,1054,406,2048
Niagara,1984,Felony,4,5,8,29,12,58
Niagara,1984,Misdemeanor,0,3,58,136,77,274
Oneida,1984,Felony,42,6,54,52,18,172
Oneida,1984,Misdemeanor,0,16,21,110,73,220
Onondaga,1984,Felony,77,60,35,161,72,405
Onondaga,1984,Misdemeanor,0,22,178,106,108,414
Ontario,1984,Felony,15,0,42,41,11,109
Ontario,1984,Misdemeanor,0,0,12,27,16,55
Orange,1984,Felony,34,34,49,72,26,215
Orange,1984,Misdemeanor,0,16,107,161,91,375
Orleans,1984,Felony,7,1,21,17,9,55
Orleans,1984,Misdemeanor,0,4,10,23,15,52
Oswego,1984,Felony,13,3,12,26,9,63
Oswego,1984,Misdemeanor,0,0,25,39,30,94
Otsego,1984,Felony,2,2,9,16,3,32
Otsego,1984,Misdemeanor,0,2,3,26,16,47
Putnam,1984,Felony,0,13,15,5,3,36
Putnam,1984,Misdemeanor,0,12,14,20,15,61
Queens,1984,Felony,390,238,49,339,308,1324
Queens,1984,Misdemeanor,0,109,35,478,251,873
Rensselaer,1984,Felony,18,4,5,17,6,50
Rensselaer,1984,Misdemeanor,0,8,44,87,47,186
Richmond,1984,Felony,31,8,1,22,30,92
Richmond,1984,Misdemeanor,0,7,3,92,40,142
Rockland,1984,Felony,15,54,75,84,28,256
Rockland,1984,Misdemeanor,0,11,30,56,42,139
St. Lawrence,1984,Felony,5,2,15,13,4,39
St. Lawrence,1984,Misdemeanor,0,1,23,24,13,61
Saratoga,1984,Felony,3,10,10,5,2,30
Saratoga,1984,Misdemeanor,0,8,9,55,34,106
Schenectady,1984,Felony,17,7,19,44,9,96
Schenectady,1984,Misdemeanor,0,7,20,59,35,121
Schoharie,1984,Felony,3,1,4,3,2,13
Schoharie,1984,Misdemeanor,0,1,0,17,11,29
Schuyler,1984,Felony,2,0,2,1,3,8
Schuyler,1984,Misdemeanor,0,1,15,14,13,43
Seneca,1984,Felony,2,1,19,0,0,22
Seneca,1984,Misdemeanor,0,0,2,13,7,22
Steuben,1984,Felony,14,2,21,17,3,57
Steuben,1984,Misdemeanor,0,0,19,43,25,87
Suffolk,1984,Felony,237,164,98,223,104,826
Suffolk,1984,Misdemeanor,0,84,899,573,349,1905
Sullivan,1984,Felony,8,7,48,53,7,123
Sullivan,1984,Misdemeanor,0,9,40,51,32,132
Tioga,1984,Felony,5,0,13,7,4,29
Tioga,1984,Misdemeanor,0,0,2,17,13,32
Tompkins,1984,Felony,5,3,13,18,10,49
Tompkins,1984,Misdemeanor,0,1,8,29,25,63
Ulster,1984,Felony,15,3,47,21,8,94
Ulster,1984,Misdemeanor,0,4,11,47,28,90
Warren,1984,Felony,1,0,2,2,4,9
Warren,1984,Misdemeanor,0,6,6,24,20,56
Washington,1984,Felony,1,0,16,2,1,20
Washington,1984,Misdemeanor,0,1,4,17,6,28
Wayne,1984,Felony,13,9,50,28,8,108
Wayne,1984,Misdemeanor,0,1,30,30,14,75
Westchester,1984,Felony,181,75,110,138,93,597
Westchester,1984,Misdemeanor,0,98,42,378,249,767
Wyoming,1984,Felony,1,0,4,3,3,11
Wyoming,1984,Misdemeanor,0,5,6,22,11,44
Yates,1984,Felony,0,0,5,5,5,15
Yates,1984,Misdemeanor,0,0,0,9,3,12
Unknown,1984,Misdemeanor,0,0,0,0,0,0
Albany,1985,Felony,9,35,32,34,41,151
Albany,1985,Misdemeanor,0,51,110,383,303,847
Allegany,1985,Felony,1,1,4,9,3,18
Allegany,1985,Misdemeanor,0,1,6,21,15,43
Bronx,1985,Felony,489,434,22,212,346,1503
Bronx,1985,Misdemeanor,0,70,28,380,318,796
Broome,1985,Felony,38,9,40,48,25,160
Broome,1985,Misdemeanor,0,8,44,73,79,204
Cattaraugus,1985,Felony,3,1,15,7,6,32
Cattaraugus,1985,Misdemeanor,0,0,6,22,16,44
Cayuga,1985,Felony,1,0,14,13,5,33
Cayuga,1985,Misdemeanor,0,2,6,13,9,30
Chautauqua,1985,Felony,12,0,12,32,10,66
Chautauqua,1985,Misdemeanor,0,3,13,100,68,184
Chemung,1985,Felony,14,3,23,29,20,89
Chemung,1985,Misdemeanor,0,0,23,88,42,153
Chenango,1985,Felony,0,1,2,4,1,8
Chenango,1985,Misdemeanor,0,3,15,63,33,114
Clinton,1985,Felony,1,0,13,14,2,30
Clinton,1985,Misdemeanor,0,1,10,34,22,67
Columbia,1985,Felony,0,2,8,3,7,20
Columbia,1985,Misdemeanor,0,1,10,45,18,74
Cortland,1985,Felony,5,4,19,5,7,40
Cortland,1985,Misdemeanor,0,4,13,36,26,79
Delaware,1985,Felony,7,2,0,6,1,16
Delaware,1985,Misdemeanor,0,0,3,21,20,44
Dutchess,1985,Felony,19,18,64,99,26,226
Dutchess,1985,Misdemeanor,0,8,67,134,72,281
Erie,1985,Felony,55,51,128,70,55,359
Erie,1985,Misdemeanor,0,91,289,638,446,1464
Essex,1985,Felony,1,0,1,5,4,11
Essex,1985,Misdemeanor,0,0,6,17,9,32
Franklin,1985,Felony,6,6,7,6,3,28
Franklin,1985,Misdemeanor,0,3,13,35,24,75
Fulton,1985,Felony,6,6,3,14,3,32
Fulton,1985,Misdemeanor,0,2,5,46,21,74
Genesee,1985,Felony,8,8,15,17,6,54
Genesee,1985,Misdemeanor,0,4,41,40,38,123
Greene,1985,Felony,0,2,4,4,1,11
Greene,1985,Misdemeanor,0,4,6,13,12,35
Hamilton,1985,Felony,0,0,0,0,0,0
Hamilton,1985,Misdemeanor,0,0,0,0,2,2
Herkimer,1985,Felony,1,0,7,9,4,21
Herkimer,1985,Misdemeanor,0,1,2,24,10,37
Jefferson,1985,Felony,20,3,16,37,14,90
Jefferson,1985,Misdemeanor,0,1,17,35,14,67
Kings,1985,Felony,711,588,1,262,518,2080
Kings,1985,Misdemeanor,0,145,101,1116,568,1930
Lewis,1985,Felony,0,0,3,2,4,9
Lewis,1985,Misdemeanor,0,2,2,11,10,25
Livingston,1985,Felony,5,1,20,13,2,41
Livingston,1985,Misdemeanor,0,6,35,31,29,101
Madison,1985,Felony,7,0,22,27,2,58
Madison,1985,Misdemeanor,0,1,27,32,17,77
Monroe,1985,Felony,69,41,154,146,64,474
Monroe,1985,Misdemeanor,0,26,290,404,233,953
Montgomery,1985,Felony,4,4,18,13,9,48
Montgomery,1985,Misdemeanor,0,2,9,9,15,35
Nassau,1985,Felony,148,145,162,168,81,704
Nassau,1985,Misdemeanor,0,158,861,936,586,2541
New York,1985,Felony,679,644,10,440,415,2188
New York,1985,Misdemeanor,0,437,42,780,281,1540
Niagara,1985,Felony,5,13,7,30,17,72
Niagara,1985,Misdemeanor,0,7,67,163,120,357
Oneida,1985,Felony,35,2,48,34,16,135
Oneida,1985,Misdemeanor,0,6,38,89,75,208
Onondaga,1985,Felony,73,60,44,148,66,391
Onondaga,1985,Misdemeanor,0,18,165,178,126,487
Ontario,1985,Felony,13,9,34,20,10,86
Ontario,1985,Misdemeanor,0,1,6,32,24,63
Orange,1985,Felony,47,53,99,57,33,289
Orange,1985,Misdemeanor,0,15,71,153,114,353
Orleans,1985,Felony,12,1,19,20,9,61
Orleans,1985,Misdemeanor,0,0,9,15,13,37
Oswego,1985,Felony,18,3,7,43,13,84
Oswego,1985,Misdemeanor,0,0,39,50,28,117
Otsego,1985,Felony,5,7,6,4,6,28
Otsego,1985,Misdemeanor,0,3,6,20,20,49
Putnam,1985,Felony,1,13,19,4,3,40
Putnam,1985,Misdemeanor,0,10,18,44,12,84
Queens,1985,Felony,302,252,84,338,358,1334
Queens,1985,Misdemeanor,0,127,49,498,314,988
Rensselaer,1985,Felony,13,6,16,46,11,92
Rensselaer,1985,Misdemeanor,0,4,32,79,53,168
Richmond,1985,Felony,30,14,0,23,35,102
Richmond,1985,Misdemeanor,0,20,9,98,68,195
Rockland,1985,Felony,34,36,86,86,40,282
Rockland,1985,Misdemeanor,0,15,40,55,64,174
St. Lawrence,1985,Felony,1,1,19,10,6,37
St. Lawrence,1985,Misdemeanor,0,2,8,38,22,70
Saratoga,1985,Felony,9,15,10,6,4,44
Saratoga,1985,Misdemeanor,0,7,28,57,39,131
Schenectady,1985,Felony,20,8,35,25,13,101
Schenectady,1985,Misdemeanor,0,5,15,84,29,133
Schoharie,1985,Felony,1,1,7,3,1,13
Schoharie,1985,Misdemeanor,0,1,5,8,8,22
Schuyler,1985,Felony,2,0,3,4,0,9
Schuyler,1985,Misdemeanor,0,2,9,25,28,64
Seneca,1985,Felony,1,0,16,1,0,18
Seneca,1985,Misdemeanor,0,1,7,11,6,25
Steuben,1985,Felony,6,0,21,12,3,42
Steuben,1985,Misdemeanor,0,1,10,25,34,70
Suffolk,1985,Felony,179,136,114,275,115,819
Suffolk,1985,Misdemeanor,0,80,915,406,356,1757
Sullivan,1985,Felony,7,12,33,22,9,83
Sullivan,1985,Misdemeanor,0,8,33,81,43,165
Tioga,1985,Felony,6,1,20,8,2,37
Tioga,1985,Misdemeanor,0,0,0,25,12,37
Tompkins,1985,Felony,9,9,25,14,6,63
Tompkins,1985,Misdemeanor,0,2,11,44,29,86
Ulster,1985,Felony,14,27,58,41,11,151
Ulster,1985,Misdemeanor,0,6,11,54,30,101
Warren,1985,Felony,2,1,3,6,2,14
Warren,1985,Misdemeanor,0,6,8,39,20,73
Washington,1985,Felony,1,0,17,3,4,25
Washington,1985,Misdemeanor,0,0,7,15,14,36
Wayne,1985,Felony,9,1,25,38,14,87
Wayne,1985,Misdemeanor,0,6,42,29,39,116
Westchester,1985,Felony,153,91,177,102,94,617
Westchester,1985,Misdemeanor,0,100,68,486,279,933
Wyoming,1985,Felony,0,0,16,0,2,18
Wyoming,1985,Misdemeanor,0,2,4,17,19,42
Yates,1985,Felony,1,2,10,9,3,25
Yates,1985,Misdemeanor,0,0,0,3,4,7
Unknown,1985,Misdemeanor,0,0,0,0,0,0
Albany,1986,Felony,26,28,45,44,31,174
Albany,1986,Misdemeanor,0,48,79,352,301,780
Allegany,1986,Felony,2,0,6,13,7,28
Allegany,1986,Misdemeanor,0,1,5,25,33,64
Bronx,1986,Felony,519,593,55,274,397,1838
Bronx,1986,Misdemeanor,0,51,51,265,220,587
Broome,1986,Felony,34,18,60,57,40,209
Broome,1986,Misdemeanor,0,10,36,100,87,233
Cattaraugus,1986,Felony,3,3,13,27,1,47
Cattaraugus,1986,Misdemeanor,0,3,10,31,16,60
Cayuga,1986,Felony,4,2,11,12,6,35
Cayuga,1986,Misdemeanor,0,0,8,16,11,35
Chautauqua,1986,Felony,10,12,11,35,14,82
Chautauqua,1986,Misdemeanor,0,5,22,101,53,181
Chemung,1986,Felony,17,0,28,36,20,101
Chemung,1986,Misdemeanor,0,0,41,84,65,190
Chenango,1986,Felony,0,0,6,3,3,12
Chenango,1986,Misdemeanor,0,1,22,39,20,82
Clinton,1986,Felony,1,1,20,10,6,38
Clinton,1986,Misdemeanor,0,6,18,57,28,109
Columbia,1986,Felony,0,1,4,3,4,12
Columbia,1986,Misdemeanor,0,6,8,38,22,74
Cortland,1986,Felony,9,2,14,14,5,44
Cortland,1986,Misdemeanor,0,3,6,29,22,60
Delaware,1986,Felony,4,6,0,3,3,16
Delaware,1986,Misdemeanor,0,0,3,30,18,51
Dutchess,1986,Felony,15,8,54,80,15,172
Dutchess,1986,Misdemeanor,0,19,46,117,69,251
Erie,1986,Felony,53,42,98,53,75,321
Erie,1986,Misdemeanor,0,96,314,613,443,1466
Essex,1986,Felony,1,0,2,9,0,12
Essex,1986,Misdemeanor,0,2,4,9,7,22
Franklin,1986,Felony,1,10,8,5,10,34
Franklin,1986,Misdemeanor,0,0,8,24,24,56
Fulton,1986,Felony,4,2,5,4,4,19
Fulton,1986,Misdemeanor,0,5,6,32,19,62
Genesee,1986,Felony,9,3,38,19,8,77
Genesee,1986,Misdemeanor,0,3,34,51,43,131
Greene,1986,Felony,2,3,11,8,2,26
Greene,1986,Misdemeanor,0,4,4,14,12,34
Hamilton,1986,Felony,1,0,0,5,1,7
Hamilton,1986,Misdemeanor,0,0,0,3,1,4
Herkimer,1986,Felony,1,2,6,5,7,21
Herkimer,1986,Misdemeanor,0,0,6,10,6,22
Jefferson,1986,Felony,13,1,35,48,11,108
Jefferson,1986,Misdemeanor,0,2,15,36,20,73
Kings,1986,Felony,727,615,18,266,558,2184
Kings,1986,Misdemeanor,0,111,153,900,459,1623
Lewis,1986,Felony,0,0,5,6,1,12
Lewis,1986,Misdemeanor,0,3,2,9,4,18
Livingston,1986,Felony,7,0,19,29,11,66
Livingston,1986,Misdemeanor,0,2,18,34,23,77
Madison,1986,Felony,10,2,29,11,8,60
Madison,1986,Misdemeanor,0,1,23,48,27,99
Monroe,1986,Felony,85,64,149,158,82,538
Monroe,1986,Misdemeanor,0,31,230,492,312,1065
Montgomery,1986,Felony,3,1,20,11,4,39
Montgomery,1986,Misdemeanor,0,2,10,17,19,48
Nassau,1986,Felony,146,115,198,163,82,704
Nassau,1986,Misdemeanor,0,175,1026,889,504,2594
New York,1986,Felony,633,867,15,494,424,2433
New York,1986,Misdemeanor,0,432,24,733,339,1528
Niagara,1986,Felony,5,4,6,26,15,56
Niagara,1986,Misdemeanor,0,12,87,169,104,372
Oneida,1986,Felony,46,9,55,48,13,171
Oneida,1986,Misdemeanor,0,7,51,80,39,177
Onondaga,1986,Felony,97,68,59,193,118,535
Onondaga,1986,Misdemeanor,0,17,194,183,136,530
Ontario,1986,Felony,11,6,75,33,13,138
Ontario,1986,Misdemeanor,0,3,11,36,20,70
Orange,1986,Felony,23,31,66,45,30,195
Orange,1986,Misdemeanor,0,21,63,160,106,350
Orleans,1986,Felony,2,0,14,7,8,31
Orleans,1986,Misdemeanor,0,0,16,27,33,76
Oswego,1986,Felony,9,5,9,46,17,86
Oswego,1986,Misdemeanor,0,1,46,63,39,149
Otsego,1986,Felony,4,5,5,6,4,24
Otsego,1986,Misdemeanor,0,0,8,26,10,44
Putnam,1986,Felony,3,18,17,4,1,43
Putnam,1986,Misdemeanor,0,9,50,34,16,109
Queens,1986,Felony,445,431,102,453,374,1805
Queens,1986,Misdemeanor,0,120,53,420,265,858
Rensselaer,1986,Felony,11,3,12,30,15,71
Rensselaer,1986,Misdemeanor,0,3,18,52,59,132
Richmond,1986,Felony,19,31,1,20,20,91
Richmond,1986,Misdemeanor,0,17,5,114,50,186
Rockland,1986,Felony,15,26,65,72,23,201
Rockland,1986,Misdemeanor,0,22,32,56,50,160
St. Lawrence,1986,Felony,8,9,22,18,4,61
St. Lawrence,1986,Misdemeanor,0,0,5,50,19,74
Saratoga,1986,Felony,13,4,22,7,13,59
Saratoga,1986,Misdemeanor,0,3,20,71,42,136
Schenectady,1986,Felony,15,8,14,29,18,84
Schenectady,1986,Misdemeanor,0,8,26,88,67,189
Schoharie,1986,Felony,0,1,5,12,5,23
Schoharie,1986,Misdemeanor,0,3,3,17,15,38
Schuyler,1986,Felony,2,0,2,7,3,14
Schuyler,1986,Misdemeanor,0,1,7,13,28,49
Seneca,1986,Felony,3,0,20,4,3,30
Seneca,1986,Misdemeanor,0,0,9,8,5,22
Steuben,1986,Felony,6,5,29,24,6,70
Steuben,1986,Misdemeanor,0,0,4,31,33,68
Suffolk,1986,Felony,167,131,147,262,142,849
Suffolk,1986,Misdemeanor,0,79,777,469,353,1678
Sullivan,1986,Felony,9,3,32,43,12,99
Sullivan,1986,Misdemeanor,0,4,49,59,41,153
Tioga,1986,Felony,4,9,19,8,5,45
Tioga,1986,Misdemeanor,0,5,7,15,14,41
Tompkins,1986,Felony,12,1,13,23,7,56
Tompkins,1986,Misdemeanor,0,1,4,28,19,52
Ulster,1986,Felony,15,5,37,40,10,107
Ulster,1986,Misdemeanor,0,9,11,80,69,169
Warren,1986,Felony,1,1,5,6,4,17
Warren,1986,Misdemeanor,0,6,6,32,19,63
Washington,1986,Felony,0,1,8,2,5,16
Washington,1986,Misdemeanor,0,3,10,22,17,52
Wayne,1986,Felony,8,3,48,27,8,94
Wayne,1986,Misdemeanor,0,4,22,36,28,90
Westchester,1986,Felony,110,83,164,123,98,578
Westchester,1986,Misdemeanor,0,184,84,503,270,1041
Wyoming,1986,Felony,1,0,15,4,4,24
Wyoming,1986,Misdemeanor,0,0,4,20,19,43
Yates,1986,Felony,5,0,12,4,6,27
Yates,1986,Misdemeanor,0,1,1,7,7,16
Unknown,1986,Misdemeanor,0,0,0,0,0,0
Albany,1987,Felony,15,40,53,28,25,161
Albany,1987,Misdemeanor,0,90,104,386,318,898
Allegany,1987,Felony,0,1,11,8,10,30
Allegany,1987,Misdemeanor,0,1,4,29,20,54
Bronx,1987,Felony,438,1073,40,270,334,2155
Bronx,1987,Misdemeanor,0,177,54,242,245,718
Broome,1987,Felony,45,19,51,51,47,213
Broome,1987,Misdemeanor,0,16,27,111,89,243
Cattaraugus,1987,Felony,7,3,39,20,5,74
Cattaraugus,1987,Misdemeanor,0,1,22,34,21,78
Cayuga,1987,Felony,3,0,18,14,7,42
Cayuga,1987,Misdemeanor,0,1,9,23,16,49
Chautauqua,1987,Felony,19,6,10,26,18,79
Chautauqua,1987,Misdemeanor,0,1,22,87,44,154
Chemung,1987,Felony,28,3,28,23,13,95
Chemung,1987,Misdemeanor,0,2,49,75,69,195
Chenango,1987,Felony,0,0,2,2,2,6
Chenango,1987,Misdemeanor,0,4,21,44,24,93
Clinton,1987,Felony,1,5,12,6,5,29
Clinton,1987,Misdemeanor,0,5,22,52,23,102
Columbia,1987,Felony,1,1,5,1,1,9
Columbia,1987,Misdemeanor,0,1,7,49,30,87
Cortland,1987,Felony,6,0,16,9,6,37
Cortland,1987,Misdemeanor,0,2,8,41,28,79
Delaware,1987,Felony,3,9,0,5,0,17
Delaware,1987,Misdemeanor,0,0,6,18,16,40
Dutchess,1987,Felony,22,26,55,91,25,219
Dutchess,1987,Misdemeanor,0,7,90,115,61,273
Erie,1987,Felony,46,91,141,75,66,419
Erie,1987,Misdemeanor,0,107,277,602,369,1355
Essex,1987,Felony,0,0,6,15,6,27
Essex,1987,Misdemeanor,0,0,1,15,9,25
Franklin,1987,Felony,2,9,5,7,8,31
Franklin,1987,Misdemeanor,0,4,9,27,14,54
Fulton,1987,Felony,1,10,2,4,2,19
Fulton,1987,Misdemeanor,0,5,1,34,30,70
Genesee,1987,Felony,11,3,23,16,10,63
Genesee,1987,Misdemeanor,0,4,24,30,31,89
Greene,1987,Felony,3,1,7,2,0,13
Greene,1987,Misdemeanor,0,2,3,27,12,44
Hamilton,1987,Felony,0,0,0,1,0,1
Hamilton,1987,Misdemeanor,0,0,0,5,1,6
Herkimer,1987,Felony,3,2,6,5,7,23
Herkimer,1987,Misdemeanor,0,0,9,12,18,39
Jefferson,1987,Felony,16,8,32,33,16,105
Jefferson,1987,Misdemeanor,0,0,11,41,30,82
Kings,1987,Felony,618,1208,11,212,478,2527
Kings,1987,Misdemeanor,0,280,114,633,413,1440
Lewis,1987,Felony,4,0,8,7,5,24
Lewis,1987,Misdemeanor,0,2,5,6,8,21
Livingston,1987,Felony,13,1,28,20,17,79
Livingston,1987,Misdemeanor,0,0,22,29,34,85
Madison,1987,Felony,9,5,20,10,3,47
Madison,1987,Misdemeanor,0,0,15,19,21,55
Monroe,1987,Felony,83,84,172,135,101,575
Monroe,1987,Misdemeanor,0,41,266,515,326,1148
Montgomery,1987,Felony,1,1,21,11,5,39
Montgomery,1987,Misdemeanor,0,4,6,15,17,42
Nassau,1987,Felony,116,214,165,109,86,690
Nassau,1987,Misdemeanor,0,189,959,889,533,2570
New York,1987,Felony,570,1513,11,442,390,2926
New York,1987,Misdemeanor,0,329,37,731,329,1426
Niagara,1987,Felony,11,29,10,15,12,77
Niagara,1987,Misdemeanor,0,15,67,156,117,355
Oneida,1987,Felony,45,12,76,50,27,210
Oneida,1987,Misdemeanor,0,9,27,82,61,179
Onondaga,1987,Felony,98,70,80,155,85,488
Onondaga,1987,Misdemeanor,0,29,216,211,177,633
Ontario,1987,Felony,7,4,75,19,14,119
Ontario,1987,Misdemeanor,0,5,8,32,33,78
Orange,1987,Felony,49,41,78,39,40,247
Orange,1987,Misdemeanor,0,55,82,212,136,485
Orleans,1987,Felony,1,4,10,4,13,32
Orleans,1987,Misdemeanor,0,5,9,31,22,67
Oswego,1987,Felony,14,5,12,58,10,99
Oswego,1987,Misdemeanor,0,3,39,63,50,155
Otsego,1987,Felony,4,6,2,8,5,25
Otsego,1987,Misdemeanor,0,1,3,30,11,45
Putnam,1987,Felony,1,8,26,1,1,37
Putnam,1987,Misdemeanor,0,20,37,30,20,107
Queens,1987,Felony,425,897,93,424,337,2176
Queens,1987,Misdemeanor,0,227,106,483,331,1147
Rensselaer,1987,Felony,17,9,13,22,19,80
Rensselaer,1987,Misdemeanor,0,9,46,45,38,138
Richmond,1987,Felony,19,63,3,19,20,124
Richmond,1987,Misdemeanor,0,17,11,93,34,155
Rockland,1987,Felony,13,11,69,56,32,181
Rockland,1987,Misdemeanor,0,29,39,63,64,195
St. Lawrence,1987,Felony,3,2,19,8,5,37
St. Lawrence,1987,Misdemeanor,0,2,9,47,23,81
Saratoga,1987,Felony,9,13,8,4,14,48
Saratoga,1987,Misdemeanor,0,6,41,50,38,135
Schenectady,1987,Felony,29,18,11,28,12,98
Schenectady,1987,Misdemeanor,0,21,37,85,64,207
Schoharie,1987,Felony,0,1,5,5,8,19
Schoharie,1987,Misdemeanor,0,0,1,17,12,30
Schuyler,1987,Felony,2,0,3,3,1,9
Schuyler,1987,Misdemeanor,0,0,5,6,6,17
Seneca,1987,Felony,8,1,13,7,8,37
Seneca,1987,Misdemeanor,0,0,5,9,7,21
Steuben,1987,Felony,11,2,42,28,11,94
Steuben,1987,Misdemeanor,0,1,10,25,15,51
Suffolk,1987,Felony,168,147,176,215,99,805
Suffolk,1987,Misdemeanor,0,135,741,569,394,1839
Sullivan,1987,Felony,4,4,48,32,16,104
Sullivan,1987,Misdemeanor,0,11,46,73,43,173
Tioga,1987,Felony,4,2,17,15,6,44
Tioga,1987,Misdemeanor,0,1,1,9,13,24
Tompkins,1987,Felony,4,6,16,15,10,51
Tompkins,1987,Misdemeanor,0,2,7,36,24,69
Ulster,1987,Felony,5,3,52,23,7,90
Ulster,1987,Misdemeanor,0,13,19,65,52,149
Warren,1987,Felony,2,0,12,2,1,17
Warren,1987,Misdemeanor,0,7,10,26,20,63
Washington,1987,Felony,4,2,10,3,2,21
Washington,1987,Misdemeanor,0,0,10,18,18,46
Wayne,1987,Felony,12,5,44,33,12,106
Wayne,1987,Misdemeanor,0,2,9,50,41,102
Westchester,1987,Felony,76,199,163,99,92,629
Westchester,1987,Misdemeanor,0,266,78,442,266,1052
Wyoming,1987,Felony,1,1,8,4,4,18
Wyoming,1987,Misdemeanor,0,0,7,14,10,31
Yates,1987,Felony,2,0,6,2,1,11
Yates,1987,Misdemeanor,0,0,3,9,9,21
Unknown,1987,Misdemeanor,0,0,0,0,0,0
Albany,1988,Felony,14,43,35,25,29,146
Albany,1988,Misdemeanor,0,134,106,350,315,905
Allegany,1988,Felony,3,0,18,15,8,44
Allegany,1988,Misdemeanor,0,1,10,32,33,76
Bronx,1988,Felony,476,1099,1,220,316,2112
Bronx,1988,Misdemeanor,0,119,57,231,246,653
Broome,1988,Felony,31,12,45,66,43,197
Broome,1988,Misdemeanor,0,9,26,117,100,252
Cattaraugus,1988,Felony,5,10,35,20,8,78
Cattaraugus,1988,Misdemeanor,0,2,22,30,25,79
Cayuga,1988,Felony,3,2,3,22,10,40
Cayuga,1988,Misdemeanor,0,1,3,30,25,59
Chautauqua,1988,Felony,8,13,15,14,5,55
Chautauqua,1988,Misdemeanor,0,4,9,74,50,137
Chemung,1988,Felony,19,3,28,28,16,94
Chemung,1988,Misdemeanor,0,0,69,78,65,212
Chenango,1988,Felony,1,0,4,4,0,9
Chenango,1988,Misdemeanor,0,1,26,36,35,98
Clinton,1988,Felony,3,16,17,4,4,44
Clinton,1988,Misdemeanor,0,4,15,42,15,76
Columbia,1988,Felony,1,0,5,3,4,13
Columbia,1988,Misdemeanor,0,7,6,30,32,75
Cortland,1988,Felony,6,7,19,10,10,52
Cortland,1988,Misdemeanor,0,2,4,32,53,91
Delaware,1988,Felony,3,3,1,2,3,12
Delaware,1988,Misdemeanor,0,1,5,19,23,48
Dutchess,1988,Felony,15,60,55,99,30,259
Dutchess,1988,Misdemeanor,0,28,155,124,86,393
Erie,1988,Felony,59,103,167,60,90,479
Erie,1988,Misdemeanor,0,123,256,454,315,1148
Essex,1988,Felony,0,1,3,7,1,12
Essex,1988,Misdemeanor,0,1,4,9,8,22
Franklin,1988,Felony,8,2,1,5,3,19
Franklin,1988,Misdemeanor,0,0,14,16,16,46
Fulton,1988,Felony,1,4,6,2,3,16
Fulton,1988,Misdemeanor,0,3,13,52,16,84
Genesee,1988,Felony,2,0,22,11,10,45
Genesee,1988,Misdemeanor,0,5,30,50,32,117
Greene,1988,Felony,1,2,9,4,2,18
Greene,1988,Misdemeanor,0,2,12,25,14,53
Hamilton,1988,Felony,0,0,0,1,1,2
Hamilton,1988,Misdemeanor,0,0,1,0,1,2
Herkimer,1988,Felony,2,6,3,1,8,20
Herkimer,1988,Misdemeanor,0,2,2,17,18,39
Jefferson,1988,Felony,18,14,50,45,19,146
Jefferson,1988,Misdemeanor,0,5,30,45,40,120
Kings,1988,Felony,755,1381,2,198,476,2812
Kings,1988,Misdemeanor,0,280,81,609,345,1315
Lewis,1988,Felony,3,0,8,2,1,14
Lewis,1988,Misdemeanor,0,0,4,7,11,22
Livingston,1988,Felony,7,0,30,12,18,67
Livingston,1988,Misdemeanor,0,4,28,33,37,102
Madison,1988,Felony,1,1,9,5,4,20
Madison,1988,Misdemeanor,0,3,21,29,13,66
Monroe,1988,Felony,69,76,81,121,97,444
Monroe,1988,Misdemeanor,0,72,355,525,366,1318
Montgomery,1988,Felony,1,2,15,4,5,27
Montgomery,1988,Misdemeanor,0,11,6,31,27,75
Nassau,1988,Felony,104,349,169,95,94,811
Nassau,1988,Misdemeanor,0,247,1032,951,574,2804
New York,1988,Felony,567,1234,10,395,422,2628
New York,1988,Misdemeanor,0,249,40,581,291,1161
Niagara,1988,Felony,8,27,15,7,11,68
Niagara,1988,Misdemeanor,0,13,74,175,101,363
Oneida,1988,Felony,46,20,46,48,18,178
Oneida,1988,Misdemeanor,0,8,37,70,56,171
Onondaga,1988,Felony,77,46,78,118,85,404
Onondaga,1988,Misdemeanor,0,46,237,231,198,712
Ontario,1988,Felony,10,5,69,20,20,124
Ontario,1988,Misdemeanor,0,10,8,34,29,81
Orange,1988,Felony,35,72,55,35,24,221
Orange,1988,Misdemeanor,0,108,110,186,112,516
Orleans,1988,Felony,1,4,14,9,1,29
Orleans,1988,Misdemeanor,0,3,26,27,29,85
Oswego,1988,Felony,9,0,10,44,11,74
Oswego,1988,Misdemeanor,0,4,42,48,42,136
Otsego,1988,Felony,4,0,2,4,3,13
Otsego,1988,Misdemeanor,0,1,6,24,17,48
Putnam,1988,Felony,0,7,0,0,1,8
Putnam,1988,Misdemeanor,0,8,46,32,20,106
Queens,1988,Felony,441,1223,74,364,378,2480
Queens,1988,Misdemeanor,0,194,134,476,314,1118
Rensselaer,1988,Felony,16,6,13,18,12,65
Rensselaer,1988,Misdemeanor,0,7,40,69,62,178
Richmond,1988,Felony,16,56,5,13,22,112
Richmond,1988,Misdemeanor,0,16,14,80,42,152
Rockland,1988,Felony,4,16,58,32,32,142
Rockland,1988,Misdemeanor,0,36,32,42,44,154
St. Lawrence,1988,Felony,0,1,4,4,2,11
St. Lawrence,1988,Misdemeanor,0,1,10,36,25,72
Saratoga,1988,Felony,9,7,2,6,7,31
Saratoga,1988,Misdemeanor,0,7,37,58,43,145
Schenectady,1988,Felony,12,6,14,27,24,83
Schenectady,1988,Misdemeanor,0,16,32,77,54,179
Schoharie,1988,Felony,1,0,3,4,4,12
Schoharie,1988,Misdemeanor,0,2,1,20,22,45
Schuyler,1988,Felony,2,0,0,3,1,6
Schuyler,1988,Misdemeanor,0,0,11,19,5,35
Seneca,1988,Felony,3,6,21,8,7,45
Seneca,1988,Misdemeanor,0,0,10,11,15,36
Steuben,1988,Felony,20,3,32,31,15,101
Steuben,1988,Misdemeanor,0,1,8,39,31,79
Suffolk,1988,Felony,131,177,221,178,97,804
Suffolk,1988,Misdemeanor,0,159,1134,548,396,2237
Sullivan,1988,Felony,8,18,43,23,12,104
Sullivan,1988,Misdemeanor,0,8,43,73,60,184
Tioga,1988,Felony,0,2,22,6,0,30
Tioga,1988,Misdemeanor,0,0,5,14,16,35
Tompkins,1988,Felony,11,11,12,18,15,67
Tompkins,1988,Misdemeanor,0,1,9,32,20,62
Ulster,1988,Felony,4,4,50,12,11,81
Ulster,1988,Misdemeanor,0,7,14,80,50,151
Warren,1988,Felony,3,3,7,1,2,16
Warren,1988,Misdemeanor,0,4,15,43,18,80
Washington,1988,Felony,1,0,12,6,4,23
Washington,1988,Misdemeanor,0,0,10,16,12,38
Wayne,1988,Felony,13,3,38,19,12,85
Wayne,1988,Misdemeanor,0,5,19,45,46,115
Westchester,1988,Felony,120,194,186,155,98,753
Westchester,1988,Misdemeanor,0,301,65,499,258,1123
Wyoming,1988,Felony,0,0,9,6,7,22
Wyoming,1988,Misdemeanor,0,0,11,15,18,44
Yates,1988,Felony,6,0,11,6,3,26
Yates,1988,Misdemeanor,0,0,5,10,5,20
Unknown,1988,Misdemeanor,0,0,0,0,0,0
Albany,1989,Felony,25,49,41,26,49,190
Albany,1989,Misdemeanor,0,145,136,379,342,1002
Allegany,1989,Felony,1,1,13,7,5,27
Allegany,1989,Misdemeanor,0,0,11,32,18,61
Bronx,1989,Felony,418,1007,4,355,286,2070
Bronx,1989,Misdemeanor,0,55,82,142,199,478
Broome,1989,Felony,32,23,29,47,65,196
Broome,1989,Misdemeanor,0,14,29,120,97,260
Cattaraugus,1989,Felony,4,4,24,19,6,57
Cattaraugus,1989,Misdemeanor,0,2,24,25,17,68
Cayuga,1989,Felony,2,4,6,16,3,31
Cayuga,1989,Misdemeanor,0,5,4,36,22,67
Chautauqua,1989,Felony,17,5,13,7,8,50
Chautauqua,1989,Misdemeanor,0,11,17,67,56,151
Chemung,1989,Felony,4,3,4,19,8,38
Chemung,1989,Misdemeanor,0,1,42,97,70,210
Chenango,1989,Felony,1,0,4,7,1,13
Chenango,1989,Misdemeanor,0,0,18,35,38,91
Clinton,1989,Felony,1,7,20,11,7,46
Clinton,1989,Misdemeanor,0,3,11,54,36,104
Columbia,1989,Felony,2,0,10,8,2,22
Columbia,1989,Misdemeanor,0,7,14,29,27,77
Cortland,1989,Felony,1,8,14,10,6,39
Cortland,1989,Misdemeanor,0,6,11,21,28,66
Delaware,1989,Felony,4,5,0,4,4,17
Delaware,1989,Misdemeanor,0,0,4,31,13,48
Dutchess,1989,Felony,16,41,43,58,23,181
Dutchess,1989,Misdemeanor,0,26,161,164,100,451
Erie,1989,Felony,63,140,152,65,75,495
Erie,1989,Misdemeanor,0,135,205,463,293,1096
Essex,1989,Felony,0,3,7,7,4,21
Essex,1989,Misdemeanor,0,3,9,16,9,37
Franklin,1989,Felony,1,5,3,1,9,19
Franklin,1989,Misdemeanor,0,4,8,18,11,41
Fulton,1989,Felony,1,3,3,5,2,14
Fulton,1989,Misdemeanor,0,2,9,50,16,77
Genesee,1989,Felony,6,4,13,13,10,46
Genesee,1989,Misdemeanor,0,3,39,48,38,128
Greene,1989,Felony,3,6,5,8,3,25
Greene,1989,Misdemeanor,0,1,7,18,17,43
Hamilton,1989,Felony,0,0,0,0,0,0
Hamilton,1989,Misdemeanor,0,0,1,0,0,1
Herkimer,1989,Felony,2,7,5,3,5,22
Herkimer,1989,Misdemeanor,0,3,10,18,8,39
Jefferson,1989,Felony,8,9,38,27,17,99
Jefferson,1989,Misdemeanor,0,4,27,51,49,131
Kings,1989,Felony,534,1977,2,171,501,3185
Kings,1989,Misdemeanor,0,270,89,668,416,1443
Lewis,1989,Felony,5,0,7,6,6,24
Lewis,1989,Misdemeanor,0,0,5,6,7,18
Livingston,1989,Felony,12,1,13,9,20,55
Livingston,1989,Misdemeanor,0,2,26,53,42,123
Madison,1989,Felony,4,3,11,10,5,33
Madison,1989,Misdemeanor,0,0,15,21,20,56
Monroe,1989,Felony,93,88,84,149,102,516
Monroe,1989,Misdemeanor,0,118,225,504,339,1186
Montgomery,1989,Felony,2,1,16,15,8,42
Montgomery,1989,Misdemeanor,0,5,18,22,23,68
Nassau,1989,Felony,99,355,181,125,112,872
Nassau,1989,Misdemeanor,0,273,1200,1021,695,3189
New York,1989,Felony,609,1640,5,376,353,2983
New York,1989,Misdemeanor,0,243,35,494,299,1071
Niagara,1989,Felony,2,15,3,9,9,38
Niagara,1989,Misdemeanor,0,40,61,153,80,334
Oneida,1989,Felony,52,15,51,35,23,176
Oneida,1989,Misdemeanor,0,8,43,59,47,157
Onondaga,1989,Felony,49,65,64,83,67,328
Onondaga,1989,Misdemeanor,0,55,205,213,231,704
Ontario,1989,Felony,7,6,60,21,7,101
Ontario,1989,Misdemeanor,0,5,8,27,31,71
Orange,1989,Felony,23,117,66,47,36,289
Orange,1989,Misdemeanor,0,146,102,187,137,572
Orleans,1989,Felony,4,9,12,13,7,45
Orleans,1989,Misdemeanor,0,0,32,46,34,112
Oswego,1989,Felony,5,6,18,39,15,83
Oswego,1989,Misdemeanor,0,2,39,35,37,113
Otsego,1989,Felony,5,4,2,5,5,21
Otsego,1989,Misdemeanor,0,4,3,17,14,38
Putnam,1989,Felony,1,3,3,2,3,12
Putnam,1989,Misdemeanor,0,18,47,38,30,133
Queens,1989,Felony,422,1336,53,373,329,2513
Queens,1989,Misdemeanor,0,178,85,403,405,1071
Rensselaer,1989,Felony,15,5,8,20,12,60
Rensselaer,1989,Misdemeanor,0,12,57,95,64,228
Richmond,1989,Felony,19,49,1,17,21,107
Richmond,1989,Misdemeanor,0,26,11,75,50,162
Rockland,1989,Felony,2,19,41,23,17,102
Rockland,1989,Misdemeanor,0,45,27,38,38,148
St. Lawrence,1989,Felony,2,2,11,18,8,41
St. Lawrence,1989,Misdemeanor,0,1,11,39,24,75
Saratoga,1989,Felony,3,14,5,11,14,47
Saratoga,1989,Misdemeanor,0,9,22,57,28,116
Schenectady,1989,Felony,7,37,14,21,10,89
Schenectady,1989,Misdemeanor,0,11,29,91,42,173
Schoharie,1989,Felony,1,3,3,3,4,14
Schoharie,1989,Misdemeanor,0,1,7,8,11,27
Schuyler,1989,Felony,4,0,4,0,0,8
Schuyler,1989,Misdemeanor,0,0,18,20,13,51
Seneca,1989,Felony,0,2,4,7,2,15
Seneca,1989,Misdemeanor,0,0,6,8,8,22
Steuben,1989,Felony,13,2,36,20,13,84
Steuben,1989,Misdemeanor,0,2,9,48,15,74
Suffolk,1989,Felony,134,231,181,174,115,835
Suffolk,1989,Misdemeanor,0,141,880,445,357,1823
Sullivan,1989,Felony,8,20,24,34,16,102
Sullivan,1989,Misdemeanor,0,12,38,66,55,171
Tioga,1989,Felony,3,2,18,8,3,34
Tioga,1989,Misdemeanor,0,0,2,31,12,45
Tompkins,1989,Felony,6,17,20,24,14,81
Tompkins,1989,Misdemeanor,0,2,11,28,27,68
Ulster,1989,Felony,2,4,16,0,4,26
Ulster,1989,Misdemeanor,0,13,18,86,49,166
Warren,1989,Felony,3,4,6,11,3,27
Warren,1989,Misdemeanor,0,6,24,41,32,103
Washington,1989,Felony,1,2,7,4,0,14
Washington,1989,Misdemeanor,0,4,15,33,26,78
Wayne,1989,Felony,4,6,47,12,10,79
Wayne,1989,Misdemeanor,0,1,18,50,43,112
Westchester,1989,Felony,127,305,198,140,115,885
Westchester,1989,Misdemeanor,0,270,90,465,271,1096
Wyoming,1989,Felony,4,0,7,3,2,16
Wyoming,1989,Misdemeanor,0,3,17,8,23,51
Yates,1989,Felony,7,0,6,7,2,22
Yates,1989,Misdemeanor,0,1,0,11,8,20
Unknown,1989,Misdemeanor,0,0,0,0,0,0
Albany,1990,Felony,17,43,38,37,29,164
Albany,1990,Misdemeanor,0,70,103,410,363,946
Allegany,1990,Felony,2,5,7,9,7,30
Allegany,1990,Misdemeanor,0,2,14,23,37,76
Bronx,1990,Felony,447,862,7,290,238,1844
Bronx,1990,Misdemeanor,0,48,61,139,195,443
Broome,1990,Felony,40,37,45,79,56,257
Broome,1990,Misdemeanor,0,11,31,98,87,227
Cattaraugus,1990,Felony,6,5,29,24,6,70
Cattaraugus,1990,Misdemeanor,0,1,20,46,40,107
Cayuga,1990,Felony,2,4,1,12,3,22
Cayuga,1990,Misdemeanor,0,4,2,12,19,37
Chautauqua,1990,Felony,16,17,10,26,27,96
Chautauqua,1990,Misdemeanor,0,4,42,70,66,182
Chemung,1990,Felony,22,7,14,32,11,86
Chemung,1990,Misdemeanor,0,1,50,83,73,207
Chenango,1990,Felony,1,0,1,2,1,5
Chenango,1990,Misdemeanor,0,1,11,35,37,84
Clinton,1990,Felony,18,7,16,16,8,65
Clinton,1990,Misdemeanor,0,6,7,66,40,119
Columbia,1990,Felony,14,3,13,10,4,44
Columbia,1990,Misdemeanor,0,13,23,42,43,121
Cortland,1990,Felony,4,10,31,14,14,73
Cortland,1990,Misdemeanor,0,4,11,36,34,85
Delaware,1990,Felony,4,4,0,6,2,16
Delaware,1990,Misdemeanor,0,0,15,26,22,63
Dutchess,1990,Felony,15,68,49,44,23,199
Dutchess,1990,Misdemeanor,0,35,155,186,95,471
Erie,1990,Felony,86,121,195,54,112,568
Erie,1990,Misdemeanor,0,123,203,578,310,1214
Essex,1990,Felony,0,3,13,7,3,26
Essex,1990,Misdemeanor,0,4,7,20,10,41
Franklin,1990,Felony,0,0,5,6,1,12
Franklin,1990,Misdemeanor,0,6,8,26,25,65
Fulton,1990,Felony,3,0,7,9,2,21
Fulton,1990,Misdemeanor,0,2,7,51,17,77
Genesee,1990,Felony,5,7,22,13,10,57
Genesee,1990,Misdemeanor,0,2,15,43,45,105
Greene,1990,Felony,3,18,2,11,7,41
Greene,1990,Misdemeanor,0,10,2,30,18,60
Hamilton,1990,Felony,0,0,1,0,1,2
Hamilton,1990,Misdemeanor,0,0,1,4,1,6
Herkimer,1990,Felony,3,16,14,9,6,48
Herkimer,1990,Misdemeanor,0,4,2,19,10,35
Jefferson,1990,Felony,21,10,30,28,14,103
Jefferson,1990,Misdemeanor,0,18,49,60,68,195
Kings,1990,Felony,752,2332,3,138,453,3678
Kings,1990,Misdemeanor,0,297,84,707,483,1571
Lewis,1990,Felony,1,0,5,2,2,10
Lewis,1990,Misdemeanor,0,0,3,10,12,25
Livingston,1990,Felony,11,4,24,21,11,71
Livingston,1990,Misdemeanor,0,1,33,49,47,130
Madison,1990,Felony,3,3,23,12,4,45
Madison,1990,Misdemeanor,0,2,27,26,30,85
Monroe,1990,Felony,104,128,68,171,111,582
Monroe,1990,Misdemeanor,0,172,251,649,421,1493
Montgomery,1990,Felony,7,4,23,12,11,57
Montgomery,1990,Misdemeanor,0,11,9,53,43,116
Nassau,1990,Felony,103,343,267,128,85,926
Nassau,1990,Misdemeanor,0,234,1330,919,601,3084
New York,1990,Felony,623,1771,3,372,332,3101
New York,1990,Misdemeanor,0,234,36,474,322,1066
Niagara,1990,Felony,10,15,5,20,10,60
Niagara,1990,Misdemeanor,0,32,83,121,100,336
Oneida,1990,Felony,49,18,42,60,20,189
Oneida,1990,Misdemeanor,0,23,30,74,62,189
Onondaga,1990,Felony,69,117,66,87,80,419
Onondaga,1990,Misdemeanor,0,86,233,261,230,810
Ontario,1990,Felony,9,15,65,30,11,130
Ontario,1990,Misdemeanor,0,5,13,38,48,104
Orange,1990,Felony,29,89,54,34,17,223
Orange,1990,Misdemeanor,0,111,106,211,175,603
Orleans,1990,Felony,5,6,6,8,5,30
Orleans,1990,Misdemeanor,0,1,34,45,45,125
Oswego,1990,Felony,11,16,15,41,15,98
Oswego,1990,Misdemeanor,0,6,40,51,37,134
Otsego,1990,Felony,8,3,9,7,6,33
Otsego,1990,Misdemeanor,0,7,8,20,19,54
Putnam,1990,Felony,2,9,21,4,2,38
Putnam,1990,Misdemeanor,0,19,63,34,34,150
Queens,1990,Felony,513,1303,42,390,327,2575
Queens,1990,Misdemeanor,0,282,65,443,340,1130
Rensselaer,1990,Felony,17,30,23,26,15,111
Rensselaer,1990,Misdemeanor,0,13,39,94,59,205
Richmond,1990,Felony,27,65,1,13,18,124
Richmond,1990,Misdemeanor,0,23,10,116,56,205
Rockland,1990,Felony,8,26,36,37,14,121
Rockland,1990,Misdemeanor,0,54,38,45,59,196
St. Lawrence,1990,Felony,2,5,4,12,5,28
St. Lawrence,1990,Misdemeanor,0,4,21,57,21,103
Saratoga,1990,Felony,5,5,11,7,10,38
Saratoga,1990,Misdemeanor,0,9,47,57,34,147
Schenectady,1990,Felony,17,30,10,18,13,88
Schenectady,1990,Misdemeanor,0,20,25,88,45,178
Schoharie,1990,Felony,3,0,0,3,1,7
Schoharie,1990,Misdemeanor,0,0,3,28,9,40
Schuyler,1990,Felony,0,2,0,8,2,12
Schuyler,1990,Misdemeanor,0,1,10,21,13,45
Seneca,1990,Felony,6,11,14,8,6,45
Seneca,1990,Misdemeanor,0,2,12,15,10,39
Steuben,1990,Felony,16,8,46,45,34,149
Steuben,1990,Misdemeanor,0,1,15,37,43,96
Suffolk,1990,Felony,152,397,175,140,82,946
Suffolk,1990,Misdemeanor,0,188,833,428,395,1844
Sullivan,1990,Felony,4,21,40,25,17,107
Sullivan,1990,Misdemeanor,0,12,56,64,43,175
Tioga,1990,Felony,7,4,9,9,5,34
Tioga,1990,Misdemeanor,0,3,7,22,17,49
Tompkins,1990,Felony,6,7,8,12,14,47
Tompkins,1990,Misdemeanor,0,4,9,27,31,71
Ulster,1990,Felony,14,8,32,13,19,86
Ulster,1990,Misdemeanor,0,14,47,95,73,229
Warren,1990,Felony,6,1,10,13,8,38
Warren,1990,Misdemeanor,0,0,15,40,26,81
Washington,1990,Felony,2,0,10,4,5,21
Washington,1990,Misdemeanor,0,5,17,25,28,75
Wayne,1990,Felony,2,12,45,30,15,104
Wayne,1990,Misdemeanor,0,3,19,68,38,128
Westchester,1990,Felony,137,392,221,169,138,1057
Westchester,1990,Misdemeanor,0,355,108,626,380,1469
Wyoming,1990,Felony,1,4,15,6,4,30
Wyoming,1990,Misdemeanor,0,4,10,23,20,57
Yates,1990,Felony,0,1,0,7,0,8
Yates,1990,Misdemeanor,0,0,3,12,12,27
Unknown,1990,Misdemeanor,0,0,0,0,0,0
Albany,1991,Felony,26,66,40,42,36,210
Albany,1991,Misdemeanor,0,100,123,445,387,1055
Allegany,1991,Felony,4,1,9,8,10,32
Allegany,1991,Misdemeanor,0,0,2,26,25,53
Bronx,1991,Felony,702,961,3,319,200,2185
Bronx,1991,Misdemeanor,0,39,58,130,214,441
Broome,1991,Felony,43,40,41,90,79,293
Broome,1991,Misdemeanor,0,11,23,89,91,214
Cattaraugus,1991,Felony,8,10,30,31,7,86
Cattaraugus,1991,Misdemeanor,0,5,12,37,43,97
Cayuga,1991,Felony,3,5,4,12,10,34
Cayuga,1991,Misdemeanor,0,2,5,23,19,49
Chautauqua,1991,Felony,32,37,10,38,14,131
Chautauqua,1991,Misdemeanor,0,12,22,89,71,194
Chemung,1991,Felony,18,3,25,25,12,83
Chemung,1991,Misdemeanor,0,4,34,64,56,158
Chenango,1991,Felony,1,1,1,8,2,13
Chenango,1991,Misdemeanor,0,1,23,39,37,100
Clinton,1991,Felony,14,5,31,24,12,86
Clinton,1991,Misdemeanor,0,1,15,75,77,168
Columbia,1991,Felony,14,7,28,12,2,63
Columbia,1991,Misdemeanor,0,11,10,64,64,149
Cortland,1991,Felony,1,7,18,21,19,66
Cortland,1991,Misdemeanor,0,6,10,31,29,76
Delaware,1991,Felony,2,0,3,6,3,14
Delaware,1991,Misdemeanor,0,1,5,23,8,37
Dutchess,1991,Felony,14,77,36,44,29,200
Dutchess,1991,Misdemeanor,0,23,149,162,114,448
Erie,1991,Felony,86,140,204,97,133,660
Erie,1991,Misdemeanor,0,151,215,625,379,1370
Essex,1991,Felony,0,5,3,9,8,25
Essex,1991,Misdemeanor,0,1,2,21,14,38
Franklin,1991,Felony,0,4,12,13,13,42
Franklin,1991,Misdemeanor,0,7,15,44,39,105
Fulton,1991,Felony,4,1,5,18,9,37
Fulton,1991,Misdemeanor,0,1,7,32,23,63
Genesee,1991,Felony,12,20,27,17,11,87
Genesee,1991,Misdemeanor,0,3,10,23,39,75
Greene,1991,Felony,6,9,2,10,4,31
Greene,1991,Misdemeanor,0,10,5,24,22,61
Hamilton,1991,Felony,0,0,3,0,1,4
Hamilton,1991,Misdemeanor,0,2,0,1,2,5
Herkimer,1991,Felony,7,1,19,13,3,43
Herkimer,1991,Misdemeanor,0,0,5,18,14,37
Jefferson,1991,Felony,32,4,34,64,25,159
Jefferson,1991,Misdemeanor,0,8,38,54,71,171
Kings,1991,Felony,1408,2468,1,307,413,4597
Kings,1991,Misdemeanor,0,223,96,638,565,1522
Lewis,1991,Felony,4,0,6,2,0,12
Lewis,1991,Misdemeanor,0,0,0,18,11,29
Livingston,1991,Felony,14,2,23,26,30,95
Livingston,1991,Misdemeanor,0,6,12,49,35,102
Madison,1991,Felony,3,2,23,8,9,45
Madison,1991,Misdemeanor,0,1,40,35,25,101
Monroe,1991,Felony,139,114,49,233,112,647
Monroe,1991,Misdemeanor,0,149,240,643,419,1451
Montgomery,1991,Felony,3,7,27,5,9,51
Montgomery,1991,Misdemeanor,0,15,6,45,40,106
Nassau,1991,Felony,119,340,245,155,94,953
Nassau,1991,Misdemeanor,0,177,1069,713,518,2477
New York,1991,Felony,784,2185,2,335,305,3611
New York,1991,Misdemeanor,0,242,47,371,320,980
Niagara,1991,Felony,3,12,2,15,10,42
Niagara,1991,Misdemeanor,0,28,110,151,106,395
Oneida,1991,Felony,52,30,70,56,22,230
Oneida,1991,Misdemeanor,0,11,30,98,84,223
Onondaga,1991,Felony,98,95,82,151,86,512
Onondaga,1991,Misdemeanor,0,50,194,299,308,851
Ontario,1991,Felony,14,1,81,34,40,170
Ontario,1991,Misdemeanor,0,5,12,33,43,93
Orange,1991,Felony,51,137,80,51,42,361
Orange,1991,Misdemeanor,0,89,140,240,225,694
Orleans,1991,Felony,3,8,9,10,9,39
Orleans,1991,Misdemeanor,0,4,36,38,30,108
Oswego,1991,Felony,9,8,28,54,16,115
Oswego,1991,Misdemeanor,0,6,41,44,56,147
Otsego,1991,Felony,10,8,11,11,16,56
Otsego,1991,Misdemeanor,0,2,15,20,18,55
Putnam,1991,Felony,1,15,23,4,2,45
Putnam,1991,Misdemeanor,0,25,59,38,41,163
Queens,1991,Felony,709,1446,36,561,333,3085
Queens,1991,Misdemeanor,0,268,75,504,373,1220
Rensselaer,1991,Felony,18,26,19,40,20,123
Rensselaer,1991,Misdemeanor,0,7,35,62,64,168
Richmond,1991,Felony,41,55,3,19,15,133
Richmond,1991,Misdemeanor,0,32,9,103,61,205
Rockland,1991,Felony,7,24,26,41,22,120
Rockland,1991,Misdemeanor,0,37,43,55,69,204
St. Lawrence,1991,Felony,4,3,9,26,14,56
St. Lawrence,1991,Misdemeanor,0,2,18,42,27,89
Saratoga,1991,Felony,0,7,17,15,9,48
Saratoga,1991,Misdemeanor,0,2,25,74,37,138
Schenectady,1991,Felony,17,24,23,26,25,115
Schenectady,1991,Misdemeanor,0,17,30,115,79,241
Schoharie,1991,Felony,2,0,8,2,2,14
Schoharie,1991,Misdemeanor,0,1,1,18,9,29
Schuyler,1991,Felony,2,3,2,3,2,12
Schuyler,1991,Misdemeanor,0,0,13,23,20,56
Seneca,1991,Felony,9,3,8,9,15,44
Seneca,1991,Misdemeanor,0,3,7,10,10,30
Steuben,1991,Felony,21,9,57,36,21,144
Steuben,1991,Misdemeanor,0,4,12,40,39,95
Suffolk,1991,Felony,149,265,214,152,110,890
Suffolk,1991,Misdemeanor,0,167,844,455,472,1938
Sullivan,1991,Felony,6,25,26,24,18,99
Sullivan,1991,Misdemeanor,0,9,45,73,39,166
Tioga,1991,Felony,9,3,16,21,8,57
Tioga,1991,Misdemeanor,0,2,5,30,26,63
Tompkins,1991,Felony,10,8,16,14,10,58
Tompkins,1991,Misdemeanor,0,4,9,64,42,119
Ulster,1991,Felony,9,14,35,25,14,97
Ulster,1991,Misdemeanor,0,22,34,110,80,246
Warren,1991,Felony,8,1,16,12,9,46
Warren,1991,Misdemeanor,0,0,16,39,44,99
Washington,1991,Felony,2,3,11,10,9,35
Washington,1991,Misdemeanor,0,1,9,30,37,77
Wayne,1991,Felony,14,15,30,19,14,92
Wayne,1991,Misdemeanor,0,6,9,51,37,103
Westchester,1991,Felony,134,300,222,146,126,928
Westchester,1991,Misdemeanor,0,410,118,636,429,1593
Wyoming,1991,Felony,1,5,7,12,4,29
Wyoming,1991,Misdemeanor,0,2,5,18,27,52
Yates,1991,Felony,4,1,0,7,2,14
Yates,1991,Misdemeanor,0,3,11,13,17,44
Unknown,1991,Misdemeanor,0,0,0,0,0,0
Albany,1992,Felony,31,77,44,41,45,238
Albany,1992,Misdemeanor,0,141,99,376,350,966
Allegany,1992,Felony,4,3,8,12,6,33
Allegany,1992,Misdemeanor,0,4,8,43,31,86
Bronx,1992,Felony,788,1075,5,279,193,2340
Bronx,1992,Misdemeanor,0,51,61,192,335,639
Broome,1992,Felony,63,62,84,64,69,342
Broome,1992,Misdemeanor,0,6,11,91,85,193
Cattaraugus,1992,Felony,5,9,43,38,14,109
Cattaraugus,1992,Misdemeanor,0,6,20,37,30,93
Cayuga,1992,Felony,2,14,9,19,7,51
Cayuga,1992,Misdemeanor,0,3,3,30,13,49
Chautauqua,1992,Felony,20,51,19,38,12,140
Chautauqua,1992,Misdemeanor,0,12,17,71,88,188
Chemung,1992,Felony,27,13,32,27,15,114
Chemung,1992,Misdemeanor,0,5,51,63,69,188
Chenango,1992,Felony,4,0,1,8,5,18
Chenango,1992,Misdemeanor,0,3,14,55,21,93
Clinton,1992,Felony,18,13,48,34,11,124
Clinton,1992,Misdemeanor,0,6,10,58,58,132
Columbia,1992,Felony,9,1,20,13,3,46
Columbia,1992,Misdemeanor,0,9,13,36,57,115
Cortland,1992,Felony,2,5,31,18,7,63
Cortland,1992,Misdemeanor,0,2,8,37,49,96
Delaware,1992,Felony,2,3,4,5,2,16
Delaware,1992,Misdemeanor,0,4,5,20,23,52
Dutchess,1992,Felony,19,55,34,65,33,206
Dutchess,1992,Misdemeanor,0,33,114,154,156,457
Erie,1992,Felony,123,274,164,90,119,770
Erie,1992,Misdemeanor,0,148,178,573,326,1225
Essex,1992,Felony,4,2,5,2,1,14
Essex,1992,Misdemeanor,0,0,2,28,16,46
Franklin,1992,Felony,1,4,10,16,5,36
Franklin,1992,Misdemeanor,0,0,12,32,34,78
Fulton,1992,Felony,5,3,7,21,11,47
Fulton,1992,Misdemeanor,0,5,6,20,30,61
Genesee,1992,Felony,7,16,28,12,24,87
Genesee,1992,Misdemeanor,0,6,22,47,52,127
Greene,1992,Felony,5,16,0,19,9,49
Greene,1992,Misdemeanor,0,12,10,19,28,69
Hamilton,1992,Felony,0,0,1,5,1,7
Hamilton,1992,Misdemeanor,0,0,1,3,6,10
Herkimer,1992,Felony,11,1,20,10,14,56
Herkimer,1992,Misdemeanor,0,0,10,24,18,52
Jefferson,1992,Felony,15,10,26,28,22,101
Jefferson,1992,Misdemeanor,0,10,47,75,83,215
Kings,1992,Felony,1343,2238,11,360,328,4280
Kings,1992,Misdemeanor,0,202,144,481,601,1428
Lewis,1992,Felony,9,1,5,3,1,19
Lewis,1992,Misdemeanor,0,4,3,19,15,41
Livingston,1992,Felony,20,8,27,21,31,107
Livingston,1992,Misdemeanor,0,3,36,68,46,153
Madison,1992,Felony,5,8,21,12,8,54
Madison,1992,Misdemeanor,0,6,27,36,32,101
Monroe,1992,Felony,123,162,122,261,119,787
Monroe,1992,Misdemeanor,0,164,249,568,405,1386
Montgomery,1992,Felony,2,3,40,7,22,74
Montgomery,1992,Misdemeanor,0,17,7,40,41,105
Nassau,1992,Felony,187,343,243,155,138,1066
Nassau,1992,Misdemeanor,0,171,808,710,521,2210
New York,1992,Felony,718,2187,7,358,268,3538
New York,1992,Misdemeanor,0,213,59,389,384,1045
Niagara,1992,Felony,8,18,4,20,8,58
Niagara,1992,Misdemeanor,0,32,114,148,116,410
Oneida,1992,Felony,52,30,86,55,30,253
Oneida,1992,Misdemeanor,0,10,53,89,79,231
Onondaga,1992,Felony,114,104,75,95,100,488
Onondaga,1992,Misdemeanor,0,72,223,310,262,867
Ontario,1992,Felony,22,14,48,37,31,152
Ontario,1992,Misdemeanor,0,2,10,40,53,105
Orange,1992,Felony,31,91,101,51,37,311
Orange,1992,Misdemeanor,0,139,172,256,263,830
Orleans,1992,Felony,5,9,13,22,3,52
Orleans,1992,Misdemeanor,0,2,28,35,24,89
Oswego,1992,Felony,16,11,48,69,17,161
Oswego,1992,Misdemeanor,0,5,40,56,52,153
Otsego,1992,Felony,6,0,5,13,8,32
Otsego,1992,Misdemeanor,0,1,24,25,27,77
Putnam,1992,Felony,3,8,39,10,9,69
Putnam,1992,Misdemeanor,0,14,67,29,32,142
Queens,1992,Felony,800,1401,56,348,319,2924
Queens,1992,Misdemeanor,0,364,31,485,389,1269
Rensselaer,1992,Felony,24,29,25,27,23,128
Rensselaer,1992,Misdemeanor,0,5,65,70,52,192
Richmond,1992,Felony,50,57,4,24,26,161
Richmond,1992,Misdemeanor,0,25,8,107,78,218
Rockland,1992,Felony,10,31,43,41,18,143
Rockland,1992,Misdemeanor,0,33,53,65,64,215
St. Lawrence,1992,Felony,8,2,18,15,5,48
St. Lawrence,1992,Misdemeanor,0,5,15,40,24,84
Saratoga,1992,Felony,11,13,16,7,7,54
Saratoga,1992,Misdemeanor,0,5,35,94,59,193
Schenectady,1992,Felony,25,29,64,31,19,168
Schenectady,1992,Misdemeanor,0,7,23,94,55,179
Schoharie,1992,Felony,1,0,6,4,1,12
Schoharie,1992,Misdemeanor,0,0,2,21,16,39
Schuyler,1992,Felony,1,2,5,6,0,14
Schuyler,1992,Misdemeanor,0,3,15,20,18,56
Seneca,1992,Felony,2,4,4,6,8,24
Seneca,1992,Misdemeanor,0,2,3,8,3,16
Steuben,1992,Felony,21,24,44,55,29,173
Steuben,1992,Misdemeanor,0,1,12,54,55,122
Suffolk,1992,Felony,242,335,173,214,138,1102
Suffolk,1992,Misdemeanor,0,158,899,572,499,2128
Sullivan,1992,Felony,6,25,33,27,9,100
Sullivan,1992,Misdemeanor,0,18,30,54,76,178
Tioga,1992,Felony,18,7,31,33,9,98
Tioga,1992,Misdemeanor,0,3,7,15,27,52
Tompkins,1992,Felony,5,11,24,15,6,61
Tompkins,1992,Misdemeanor,0,8,33,54,46,141
Ulster,1992,Felony,12,22,43,24,19,120
Ulster,1992,Misdemeanor,0,17,21,84,90,212
Warren,1992,Felony,6,0,10,10,9,35
Warren,1992,Misdemeanor,0,2,12,58,33,105
Washington,1992,Felony,2,1,7,5,3,18
Washington,1992,Misdemeanor,0,3,12,33,38,86
Wayne,1992,Felony,16,17,39,37,25,134
Wayne,1992,Misdemeanor,0,5,9,66,42,122
Westchester,1992,Felony,157,285,150,129,87,808
Westchester,1992,Misdemeanor,0,308,121,575,417,1421
Wyoming,1992,Felony,1,2,6,15,4,28
Wyoming,1992,Misdemeanor,0,3,12,26,9,50
Yates,1992,Felony,2,1,2,10,2,17
Yates,1992,Misdemeanor,0,0,4,15,8,27
Unknown,1992,Misdemeanor,0,0,0,0,0,0
Albany,1993,Felony,11,37,47,34,43,172
Albany,1993,Misdemeanor,0,138,89,357,304,888
Allegany,1993,Felony,1,0,15,8,13,37
Allegany,1993,Misdemeanor,0,3,6,31,39,79
Bronx,1993,Felony,815,946,2,205,208,2176
Bronx,1993,Misdemeanor,0,74,61,158,370,663
Broome,1993,Felony,54,46,61,74,75,310
Broome,1993,Misdemeanor,0,23,14,94,100,231
Cattaraugus,1993,Felony,4,6,60,12,12,94
Cattaraugus,1993,Misdemeanor,0,5,31,61,40,137
Cayuga,1993,Felony,0,6,8,11,10,35
Cayuga,1993,Misdemeanor,0,2,3,38,40,83
Chautauqua,1993,Felony,15,23,22,32,22,114
Chautauqua,1993,Misdemeanor,0,13,24,80,71,188
Chemung,1993,Felony,11,11,31,16,12,81
Chemung,1993,Misdemeanor,0,8,39,59,33,139
Chenango,1993,Felony,1,4,2,8,4,19
Chenango,1993,Misdemeanor,0,7,14,29,37,87
Clinton,1993,Felony,12,14,52,36,16,130
Clinton,1993,Misdemeanor,0,4,14,67,67,152
Columbia,1993,Felony,7,2,31,12,4,56
Columbia,1993,Misdemeanor,0,12,15,37,43,107
Cortland,1993,Felony,6,3,26,13,9,57
Cortland,1993,Misdemeanor,0,4,7,37,34,82
Delaware,1993,Felony,2,3,4,6,2,17
Delaware,1993,Misdemeanor,0,3,12,23,24,62
Dutchess,1993,Felony,24,88,79,47,27,265
Dutchess,1993,Misdemeanor,0,37,116,183,131,467
Erie,1993,Felony,115,258,192,105,91,761
Erie,1993,Misdemeanor,0,153,205,548,355,1261
Essex,1993,Felony,1,0,12,8,8,29
Essex,1993,Misdemeanor,0,3,3,24,16,46
Franklin,1993,Felony,1,2,13,6,10,32
Franklin,1993,Misdemeanor,0,0,22,23,45,90
Fulton,1993,Felony,4,6,7,10,13,40
Fulton,1993,Misdemeanor,0,7,16,19,30,72
Genesee,1993,Felony,2,13,15,9,11,50
Genesee,1993,Misdemeanor,0,2,19,37,35,93
Greene,1993,Felony,5,9,7,15,11,47
Greene,1993,Misdemeanor,0,8,16,28,24,76
Hamilton,1993,Felony,2,0,2,3,0,7
Hamilton,1993,Misdemeanor,0,0,2,5,2,9
Herkimer,1993,Felony,17,3,23,16,4,63
Herkimer,1993,Misdemeanor,0,1,3,19,29,52
Jefferson,1993,Felony,24,12,29,40,30,135
Jefferson,1993,Misdemeanor,0,8,49,64,57,178
Kings,1993,Felony,1099,2125,4,205,218,3651
Kings,1993,Misdemeanor,0,263,127,433,588,1411
Lewis,1993,Felony,8,2,10,1,6,27
Lewis,1993,Misdemeanor,0,3,9,10,12,34
Livingston,1993,Felony,7,10,22,31,16,86
Livingston,1993,Misdemeanor,0,10,33,39,29,111
Madison,1993,Felony,9,4,25,4,3,45
Madison,1993,Misdemeanor,0,3,34,39,44,120
Monroe,1993,Felony,114,198,136,209,141,798
Monroe,1993,Misdemeanor,0,134,277,504,416,1331
Montgomery,1993,Felony,0,8,15,12,12,47
Montgomery,1993,Misdemeanor,0,9,8,38,49,104
Nassau,1993,Felony,106,291,231,99,113,840
Nassau,1993,Misdemeanor,0,190,1210,763,591,2754
New York,1993,Felony,710,2087,3,360,274,3434
New York,1993,Misdemeanor,0,215,53,377,366,1011
Niagara,1993,Felony,2,8,14,10,9,43
Niagara,1993,Misdemeanor,0,24,98,159,110,391
Oneida,1993,Felony,56,49,74,50,35,264
Oneida,1993,Misdemeanor,0,17,49,86,81,233
Onondaga,1993,Felony,116,115,112,104,100,547
Onondaga,1993,Misdemeanor,0,73,188,241,250,752
Ontario,1993,Felony,13,11,55,25,28,132
Ontario,1993,Misdemeanor,0,3,11,48,42,104
Orange,1993,Felony,56,97,109,52,28,342
Orange,1993,Misdemeanor,0,141,140,258,245,784
Orleans,1993,Felony,1,7,8,11,7,34
Orleans,1993,Misdemeanor,0,6,34,48,32,120
Oswego,1993,Felony,8,3,28,44,13,96
Oswego,1993,Misdemeanor,0,5,37,63,50,155
Otsego,1993,Felony,4,2,11,7,5,29
Otsego,1993,Misdemeanor,0,0,19,25,13,57
Putnam,1993,Felony,5,20,52,8,8,93
Putnam,1993,Misdemeanor,0,12,34,29,20,95
Queens,1993,Felony,819,1149,84,234,323,2609
Queens,1993,Misdemeanor,0,315,20,398,338,1071
Rensselaer,1993,Felony,13,23,14,29,14,93
Rensselaer,1993,Misdemeanor,0,7,43,51,56,157
Richmond,1993,Felony,45,69,3,25,33,175
Richmond,1993,Misdemeanor,0,16,5,108,53,182
Rockland,1993,Felony,23,33,36,38,14,144
Rockland,1993,Misdemeanor,0,31,39,64,78,212
St. Lawrence,1993,Felony,10,5,8,11,6,40
St. Lawrence,1993,Misdemeanor,0,4,35,48,33,120
Saratoga,1993,Felony,8,4,10,7,6,35
Saratoga,1993,Misdemeanor,0,14,35,63,58,170
Schenectady,1993,Felony,18,19,79,50,32,198
Schenectady,1993,Misdemeanor,0,20,28,110,66,224
Schoharie,1993,Felony,6,0,4,1,1,12
Schoharie,1993,Misdemeanor,0,6,8,29,14,57
Schuyler,1993,Felony,4,0,3,5,1,13
Schuyler,1993,Misdemeanor,0,2,6,17,16,41
Seneca,1993,Felony,7,1,8,3,8,27
Seneca,1993,Misdemeanor,0,1,5,12,7,25
Steuben,1993,Felony,16,9,37,47,34,143
Steuben,1993,Misdemeanor,0,7,7,30,33,77
Suffolk,1993,Felony,218,260,200,190,122,990
Suffolk,1993,Misdemeanor,0,186,727,550,560,2023
Sullivan,1993,Felony,7,18,46,29,16,116
Sullivan,1993,Misdemeanor,0,11,41,70,57,179
Tioga,1993,Felony,5,0,25,16,7,53
Tioga,1993,Misdemeanor,0,4,1,30,25,60
Tompkins,1993,Felony,7,3,21,12,18,61
Tompkins,1993,Misdemeanor,0,4,34,65,64,167
Ulster,1993,Felony,12,10,45,31,16,114
Ulster,1993,Misdemeanor,0,43,45,110,89,287
Warren,1993,Felony,7,1,25,21,17,71
Warren,1993,Misdemeanor,0,1,15,34,25,75
Washington,1993,Felony,3,2,8,4,6,23
Washington,1993,Misdemeanor,0,0,18,52,39,109
Wayne,1993,Felony,16,13,54,40,25,148
Wayne,1993,Misdemeanor,0,5,13,54,68,140
Westchester,1993,Felony,151,172,175,117,83,698
Westchester,1993,Misdemeanor,0,261,124,561,419,1365
Wyoming,1993,Felony,1,2,10,16,7,36
Wyoming,1993,Misdemeanor,0,3,10,32,13,58
Yates,1993,Felony,1,2,16,4,0,23
Yates,1993,Misdemeanor,0,0,0,6,14,20
Unknown,1993,Misdemeanor,0,0,0,0,0,0
Albany,1994,Felony,22,50,40,32,30,174
Albany,1994,Misdemeanor,0,131,79,358,285,853
Allegany,1994,Felony,6,5,15,9,16,51
Allegany,1994,Misdemeanor,0,4,8,36,34,82
Bronx,1994,Felony,791,1179,5,193,238,2406
Bronx,1994,Misdemeanor,0,57,40,163,528,788
Broome,1994,Felony,57,57,65,55,77,311
Broome,1994,Misdemeanor,0,20,23,80,96,219
Cattaraugus,1994,Felony,4,9,19,22,10,64
Cattaraugus,1994,Misdemeanor,0,6,34,45,42,127
Cayuga,1994,Felony,5,8,5,9,8,35
Cayuga,1994,Misdemeanor,0,1,3,29,43,76
Chautauqua,1994,Felony,14,25,34,30,20,123
Chautauqua,1994,Misdemeanor,0,7,37,68,85,197
Chemung,1994,Felony,9,8,39,12,10,78
Chemung,1994,Misdemeanor,0,7,33,66,52,158
Chenango,1994,Felony,1,0,1,7,5,14
Chenango,1994,Misdemeanor,0,1,13,42,24,80
Clinton,1994,Felony,7,7,39,26,12,91
Clinton,1994,Misdemeanor,0,4,13,66,48,131
Columbia,1994,Felony,6,6,38,17,4,71
Columbia,1994,Misdemeanor,0,7,5,40,53,105
Cortland,1994,Felony,9,3,25,7,9,53
Cortland,1994,Misdemeanor,0,4,22,53,54,133
Delaware,1994,Felony,3,1,5,6,4,19
Delaware,1994,Misdemeanor,0,2,12,29,35,78
Dutchess,1994,Felony,42,64,83,73,26,288
Dutchess,1994,Misdemeanor,0,35,126,180,186,527
Erie,1994,Felony,148,272,180,79,110,789
Erie,1994,Misdemeanor,0,225,219,589,432,1465
Essex,1994,Felony,4,1,12,3,7,27
Essex,1994,Misdemeanor,0,1,14,19,20,54
Franklin,1994,Felony,1,1,8,4,5,19
Franklin,1994,Misdemeanor,0,4,15,32,54,105
Fulton,1994,Felony,11,2,9,18,8,48
Fulton,1994,Misdemeanor,0,1,8,31,41,81
Genesee,1994,Felony,9,6,24,11,14,64
Genesee,1994,Misdemeanor,0,5,21,46,38,110
Greene,1994,Felony,3,6,14,6,4,33
Greene,1994,Misdemeanor,0,6,16,25,18,65
Hamilton,1994,Felony,0,0,2,0,1,3
Hamilton,1994,Misdemeanor,0,0,4,0,0,4
Herkimer,1994,Felony,7,10,22,8,5,52
Herkimer,1994,Misdemeanor,0,1,6,15,18,40
Jefferson,1994,Felony,27,21,44,25,17,134
Jefferson,1994,Misdemeanor,0,3,19,76,59,157
Kings,1994,Felony,856,1798,14,201,223,3092
Kings,1994,Misdemeanor,0,415,171,379,911,1876
Lewis,1994,Felony,3,1,19,5,1,29
Lewis,1994,Misdemeanor,0,0,9,23,13,45
Livingston,1994,Felony,2,4,36,24,28,94
Livingston,1994,Misdemeanor,0,6,22,57,45,130
Madison,1994,Felony,9,2,20,7,2,40
Madison,1994,Misdemeanor,0,3,33,41,31,108
Monroe,1994,Felony,90,161,143,151,112,657
Monroe,1994,Misdemeanor,0,196,285,582,434,1497
Montgomery,1994,Felony,5,8,16,8,10,47
Montgomery,1994,Misdemeanor,0,6,7,47,41,101
Nassau,1994,Felony,134,252,307,150,180,1023
Nassau,1994,Misdemeanor,0,195,1185,658,731,2769
New York,1994,Felony,629,1901,10,356,256,3152
New York,1994,Misdemeanor,0,192,58,357,422,1029
Niagara,1994,Felony,4,30,22,11,20,87
Niagara,1994,Misdemeanor,0,30,118,167,115,430
Oneida,1994,Felony,45,45,79,41,31,241
Oneida,1994,Misdemeanor,0,12,56,94,72,234
Onondaga,1994,Felony,103,114,111,116,119,563
Onondaga,1994,Misdemeanor,0,65,192,273,312,842
Ontario,1994,Felony,16,6,59,29,22,132
Ontario,1994,Misdemeanor,0,4,20,39,41,104
Orange,1994,Felony,39,55,114,62,46,316
Orange,1994,Misdemeanor,0,162,136,263,283,844
Orleans,1994,Felony,2,8,6,8,6,30
Orleans,1994,Misdemeanor,0,6,28,30,29,93
Oswego,1994,Felony,5,6,22,27,9,69
Oswego,1994,Misdemeanor,0,1,47,81,57,186
Otsego,1994,Felony,8,2,9,7,9,35
Otsego,1994,Misdemeanor,0,5,25,23,32,85
Putnam,1994,Felony,2,24,32,12,3,73
Putnam,1994,Misdemeanor,0,14,52,21,32,119
Queens,1994,Felony,869,1072,70,356,369,2736
Queens,1994,Misdemeanor,0,193,36,426,439,1094
Rensselaer,1994,Felony,11,34,14,22,15,96
Rensselaer,1994,Misdemeanor,0,11,41,74,78,204
Richmond,1994,Felony,42,67,1,24,14,148
Richmond,1994,Misdemeanor,0,11,22,58,66,157
Rockland,1994,Felony,10,15,37,26,20,108
Rockland,1994,Misdemeanor,0,38,48,65,50,201
St. Lawrence,1994,Felony,11,15,27,20,11,84
St. Lawrence,1994,Misdemeanor,0,7,21,64,44,136
Saratoga,1994,Felony,11,5,16,10,6,48
Saratoga,1994,Misdemeanor,0,4,41,58,55,158
Schenectady,1994,Felony,9,11,51,37,25,133
Schenectady,1994,Misdemeanor,0,12,17,100,72,201
Schoharie,1994,Felony,0,1,14,4,0,19
Schoharie,1994,Misdemeanor,0,0,4,12,12,28
Schuyler,1994,Felony,2,2,2,2,2,10
Schuyler,1994,Misdemeanor,0,1,11,16,15,43
Seneca,1994,Felony,6,0,5,6,2,19
Seneca,1994,Misdemeanor,0,3,3,3,6,15
Steuben,1994,Felony,8,8,53,51,37,157
Steuben,1994,Misdemeanor,0,8,12,43,49,112
Suffolk,1994,Felony,214,233,314,185,147,1093
Suffolk,1994,Misdemeanor,0,211,666,591,683,2151
Sullivan,1994,Felony,15,17,35,38,27,132
Sullivan,1994,Misdemeanor,0,8,28,76,68,180
Tioga,1994,Felony,6,0,25,13,15,59
Tioga,1994,Misdemeanor,0,1,5,25,27,58
Tompkins,1994,Felony,7,9,19,17,22,74
Tompkins,1994,Misdemeanor,0,11,33,59,54,157
Ulster,1994,Felony,17,22,94,36,30,199
Ulster,1994,Misdemeanor,0,63,44,117,108,332
Warren,1994,Felony,12,3,25,9,6,55
Warren,1994,Misdemeanor,0,11,22,52,53,138
Washington,1994,Felony,2,1,10,10,2,25
Washington,1994,Misdemeanor,0,3,15,33,42,93
Wayne,1994,Felony,16,14,62,43,22,157
Wayne,1994,Misdemeanor,0,12,19,65,73,169
Westchester,1994,Felony,172,180,165,137,98,752
Westchester,1994,Misdemeanor,0,349,109,581,503,1542
Wyoming,1994,Felony,2,1,16,29,2,50
Wyoming,1994,Misdemeanor,0,4,17,35,24,80
Yates,1994,Felony,0,1,11,6,5,23
Yates,1994,Misdemeanor,0,0,2,2,4,8
Unknown,1994,Misdemeanor,0,0,0,0,0,0
Albany,1995,Felony,10,45,39,49,31,174
Albany,1995,Misdemeanor,0,123,79,472,355,1029
Allegany,1995,Felony,2,3,10,11,9,35
Allegany,1995,Misdemeanor,0,2,13,28,55,98
Bronx,1995,Felony,632,1266,2,150,220,2270
Bronx,1995,Misdemeanor,0,66,72,147,627,912
Broome,1995,Felony,49,51,41,75,78,294
Broome,1995,Misdemeanor,0,28,18,96,118,260
Cattaraugus,1995,Felony,2,4,26,13,12,57
Cattaraugus,1995,Misdemeanor,0,6,26,48,58,138
Cayuga,1995,Felony,6,7,7,14,4,38
Cayuga,1995,Misdemeanor,0,12,14,57,38,121
Chautauqua,1995,Felony,24,43,33,26,23,149
Chautauqua,1995,Misdemeanor,0,5,26,65,82,178
Chemung,1995,Felony,12,5,51,26,8,102
Chemung,1995,Misdemeanor,0,6,27,53,35,121
Chenango,1995,Felony,0,1,3,10,10,24
Chenango,1995,Misdemeanor,0,2,10,44,48,104
Clinton,1995,Felony,6,12,41,19,11,89
Clinton,1995,Misdemeanor,0,4,18,70,69,161
Columbia,1995,Felony,6,4,23,17,5,55
Columbia,1995,Misdemeanor,0,12,8,54,50,124
Cortland,1995,Felony,6,6,23,17,13,65
Cortland,1995,Misdemeanor,0,1,18,54,49,122
Delaware,1995,Felony,0,0,7,6,1,14
Delaware,1995,Misdemeanor,0,4,24,45,50,123
Dutchess,1995,Felony,13,119,92,62,43,329
Dutchess,1995,Misdemeanor,0,28,129,170,147,474
Erie,1995,Felony,120,209,226,88,94,737
Erie,1995,Misdemeanor,0,231,302,598,442,1573
Essex,1995,Felony,6,2,6,9,13,36
Essex,1995,Misdemeanor,0,2,9,16,25,52
Franklin,1995,Felony,0,0,9,7,8,24
Franklin,1995,Misdemeanor,0,3,14,60,71,148
Fulton,1995,Felony,1,3,6,30,16,56
Fulton,1995,Misdemeanor,0,4,18,30,45,97
Genesee,1995,Felony,10,5,33,10,10,68
Genesee,1995,Misdemeanor,0,8,20,38,33,99
Greene,1995,Felony,3,5,5,7,6,26
Greene,1995,Misdemeanor,0,2,12,30,20,64
Hamilton,1995,Felony,0,0,2,1,0,3
Hamilton,1995,Misdemeanor,0,1,1,4,3,9
Herkimer,1995,Felony,10,4,8,6,11,39
Herkimer,1995,Misdemeanor,0,1,5,31,20,57
Jefferson,1995,Felony,23,21,33,26,18,121
Jefferson,1995,Misdemeanor,0,12,15,90,96,213
Kings,1995,Felony,792,1492,22,229,295,2830
Kings,1995,Misdemeanor,0,548,281,381,1089,2299
Lewis,1995,Felony,5,0,9,11,6,31
Lewis,1995,Misdemeanor,0,7,1,33,14,55
Livingston,1995,Felony,3,4,29,15,23,74
Livingston,1995,Misdemeanor,0,6,26,71,83,186
Madison,1995,Felony,3,4,24,3,4,38
Madison,1995,Misdemeanor,0,8,20,43,38,109
Monroe,1995,Felony,111,128,157,151,114,661
Monroe,1995,Misdemeanor,0,148,308,579,473,1508
Montgomery,1995,Felony,4,7,16,6,7,40
Montgomery,1995,Misdemeanor,0,9,8,49,30,96
Nassau,1995,Felony,148,269,291,124,183,1015
Nassau,1995,Misdemeanor,0,145,938,623,725,2431
New York,1995,Felony,526,2070,8,351,288,3243
New York,1995,Misdemeanor,0,216,64,289,489,1058
Niagara,1995,Felony,5,45,23,16,11,100
Niagara,1995,Misdemeanor,0,37,93,139,104,373
Oneida,1995,Felony,43,38,72,32,31,216
Oneida,1995,Misdemeanor,0,18,46,102,60,226
Onondaga,1995,Felony,67,116,93,105,101,482
Onondaga,1995,Misdemeanor,0,117,144,330,392,983
Ontario,1995,Felony,19,15,78,35,24,171
Ontario,1995,Misdemeanor,0,4,21,52,62,139
Orange,1995,Felony,53,56,115,49,57,330
Orange,1995,Misdemeanor,0,141,150,294,285,870
Orleans,1995,Felony,1,4,4,2,0,11
Orleans,1995,Misdemeanor,0,9,31,52,52,144
Oswego,1995,Felony,21,5,32,43,13,114
Oswego,1995,Misdemeanor,0,4,47,82,42,175
Otsego,1995,Felony,1,0,12,9,2,24
Otsego,1995,Misdemeanor,0,2,13,26,19,60
Putnam,1995,Felony,0,11,30,7,7,55
Putnam,1995,Misdemeanor,0,13,55,29,20,117
Queens,1995,Felony,869,1001,81,403,415,2769
Queens,1995,Misdemeanor,0,189,37,504,490,1220
Rensselaer,1995,Felony,12,30,37,23,18,120
Rensselaer,1995,Misdemeanor,0,15,22,92,99,228
Richmond,1995,Felony,40,112,1,19,24,196
Richmond,1995,Misdemeanor,0,28,19,72,89,208
Rockland,1995,Felony,31,28,40,41,38,178
Rockland,1995,Misdemeanor,0,42,42,69,71,224
St. Lawrence,1995,Felony,7,9,29,15,14,74
St. Lawrence,1995,Misdemeanor,0,7,14,57,48,126
Saratoga,1995,Felony,9,1,18,7,11,46
Saratoga,1995,Misdemeanor,0,6,43,90,70,209
Schenectady,1995,Felony,34,23,34,25,31,147
Schenectady,1995,Misdemeanor,0,8,24,80,33,145
Schoharie,1995,Felony,2,1,4,3,6,16
Schoharie,1995,Misdemeanor,0,1,6,10,16,33
Schuyler,1995,Felony,2,0,2,3,0,7
Schuyler,1995,Misdemeanor,0,4,2,23,16,45
Seneca,1995,Felony,2,0,13,15,4,34
Seneca,1995,Misdemeanor,0,0,4,7,12,23
Steuben,1995,Felony,20,5,39,36,27,127
Steuben,1995,Misdemeanor,0,9,17,38,52,116
Suffolk,1995,Felony,217,199,425,155,167,1163
Suffolk,1995,Misdemeanor,0,238,1075,650,756,2719
Sullivan,1995,Felony,8,8,37,36,26,115
Sullivan,1995,Misdemeanor,0,15,31,79,65,190
Tioga,1995,Felony,2,1,20,13,10,46
Tioga,1995,Misdemeanor,0,4,10,18,33,65
Tompkins,1995,Felony,3,8,18,10,11,50
Tompkins,1995,Misdemeanor,0,8,30,73,66,177
Ulster,1995,Felony,21,10,68,24,22,145
Ulster,1995,Misdemeanor,0,74,33,109,152,368
Warren,1995,Felony,5,5,15,9,10,44
Warren,1995,Misdemeanor,0,3,36,67,45,151
Washington,1995,Felony,4,4,15,21,7,51
Washington,1995,Misdemeanor,0,4,19,35,48,106
Wayne,1995,Felony,14,13,49,32,21,129
Wayne,1995,Misdemeanor,0,10,17,77,91,195
Westchester,1995,Felony,178,116,181,107,118,700
Westchester,1995,Misdemeanor,0,333,143,653,627,1756
Wyoming,1995,Felony,1,4,11,12,10,38
Wyoming,1995,Misdemeanor,0,3,18,24,30,75
Yates,1995,Felony,1,2,12,4,5,24
Yates,1995,Misdemeanor,0,0,1,8,24,33
Unknown,1995,Misdemeanor,0,0,0,0,0,0
Albany,1996,Felony,24,42,26,46,34,172
Albany,1996,Misdemeanor,0,100,73,414,326,913
Allegany,1996,Felony,5,2,22,12,11,52
Allegany,1996,Misdemeanor,0,10,10,35,34,89
Bronx,1996,Felony,454,1359,5,172,181,2171
Bronx,1996,Misdemeanor,0,71,51,173,655,950
Broome,1996,Felony,48,70,77,91,79,365
Broome,1996,Misdemeanor,0,11,15,93,79,198
Cattaraugus,1996,Felony,1,7,36,29,7,80
Cattaraugus,1996,Misdemeanor,0,17,31,72,61,181
Cayuga,1996,Felony,4,13,11,11,9,48
Cayuga,1996,Misdemeanor,0,12,9,49,51,121
Chautauqua,1996,Felony,22,53,46,22,27,170
Chautauqua,1996,Misdemeanor,0,24,29,80,85,218
Chemung,1996,Felony,14,9,37,25,12,97
Chemung,1996,Misdemeanor,0,8,35,49,43,135
Chenango,1996,Felony,2,0,4,3,2,11
Chenango,1996,Misdemeanor,0,1,7,48,22,78
Clinton,1996,Felony,6,4,64,28,19,121
Clinton,1996,Misdemeanor,0,6,22,82,116,226
Columbia,1996,Felony,0,1,30,19,6,56
Columbia,1996,Misdemeanor,0,32,17,65,98,212
Cortland,1996,Felony,9,8,21,11,14,63
Cortland,1996,Misdemeanor,0,0,13,45,57,115
Delaware,1996,Felony,1,2,6,3,1,13
Delaware,1996,Misdemeanor,0,6,19,38,41,104
Dutchess,1996,Felony,21,103,52,38,29,243
Dutchess,1996,Misdemeanor,0,50,109,232,181,572
Erie,1996,Felony,104,282,224,106,166,882
Erie,1996,Misdemeanor,0,187,235,601,437,1460
Essex,1996,Felony,4,2,11,9,4,30
Essex,1996,Misdemeanor,0,1,5,18,36,60
Franklin,1996,Felony,3,4,12,16,6,41
Franklin,1996,Misdemeanor,0,9,7,41,48,105
Fulton,1996,Felony,6,4,5,16,9,40
Fulton,1996,Misdemeanor,0,1,12,31,32,76
Genesee,1996,Felony,16,11,31,7,20,85
Genesee,1996,Misdemeanor,0,12,24,47,49,132
Greene,1996,Felony,1,4,8,8,9,30
Greene,1996,Misdemeanor,0,0,8,43,22,73
Hamilton,1996,Felony,0,0,4,1,1,6
Hamilton,1996,Misdemeanor,0,0,0,3,1,4
Herkimer,1996,Felony,15,4,17,16,8,60
Herkimer,1996,Misdemeanor,0,2,3,24,23,52
Jefferson,1996,Felony,23,12,17,40,24,116
Jefferson,1996,Misdemeanor,0,7,10,67,70,154
Kings,1996,Felony,641,1135,22,233,349,2380
Kings,1996,Misdemeanor,0,326,162,413,1242,2143
Lewis,1996,Felony,4,3,12,8,9,36
Lewis,1996,Misdemeanor,0,1,3,31,16,51
Livingston,1996,Felony,8,2,40,15,19,84
Livingston,1996,Misdemeanor,0,1,23,40,55,119
Madison,1996,Felony,9,3,18,7,6,43
Madison,1996,Misdemeanor,0,9,27,41,45,122
Monroe,1996,Felony,121,192,162,224,154,853
Monroe,1996,Misdemeanor,0,187,336,620,630,1773
Montgomery,1996,Felony,3,4,23,17,5,52
Montgomery,1996,Misdemeanor,0,11,7,51,48,117
Nassau,1996,Felony,124,264,330,98,160,976
Nassau,1996,Misdemeanor,0,134,987,587,630,2338
New York,1996,Felony,400,2133,13,315,297,3158
New York,1996,Misdemeanor,0,207,45,340,658,1250
Niagara,1996,Felony,5,21,34,24,10,94
Niagara,1996,Misdemeanor,0,57,101,151,152,461
Oneida,1996,Felony,46,36,99,55,31,267
Oneida,1996,Misdemeanor,0,22,35,131,93,281
Onondaga,1996,Felony,67,112,80,104,73,436
Onondaga,1996,Misdemeanor,0,102,199,369,500,1170
Ontario,1996,Felony,18,11,77,47,31,184
Ontario,1996,Misdemeanor,0,15,17,66,59,157
Orange,1996,Felony,55,68,89,47,50,309
Orange,1996,Misdemeanor,0,132,128,301,266,827
Orleans,1996,Felony,1,9,13,5,5,33
Orleans,1996,Misdemeanor,0,3,26,62,57,148
Oswego,1996,Felony,20,6,38,40,21,125
Oswego,1996,Misdemeanor,0,8,35,70,57,170
Otsego,1996,Felony,2,2,10,4,3,21
Otsego,1996,Misdemeanor,0,5,9,39,28,81
Putnam,1996,Felony,2,22,30,11,10,75
Putnam,1996,Misdemeanor,0,35,42,29,27,133
Queens,1996,Felony,639,964,72,415,375,2465
Queens,1996,Misdemeanor,0,204,33,510,419,1166
Rensselaer,1996,Felony,17,37,31,20,20,125
Rensselaer,1996,Misdemeanor,0,17,23,100,133,273
Richmond,1996,Felony,62,240,9,29,47,387
Richmond,1996,Misdemeanor,0,47,21,99,160,327
Rockland,1996,Felony,33,59,44,41,28,205
Rockland,1996,Misdemeanor,0,30,43,80,69,222
St. Lawrence,1996,Felony,12,9,15,24,22,82
St. Lawrence,1996,Misdemeanor,0,9,16,55,48,128
Saratoga,1996,Felony,7,7,16,18,10,58
Saratoga,1996,Misdemeanor,0,12,22,95,74,203
Schenectady,1996,Felony,12,20,30,16,16,94
Schenectady,1996,Misdemeanor,0,13,13,95,48,169
Schoharie,1996,Felony,0,9,5,2,1,17
Schoharie,1996,Misdemeanor,0,0,5,17,15,37
Schuyler,1996,Felony,1,0,0,1,0,2
Schuyler,1996,Misdemeanor,0,1,5,16,19,41
Seneca,1996,Felony,2,1,7,12,2,24
Seneca,1996,Misdemeanor,0,1,4,7,17,29
Steuben,1996,Felony,23,6,51,39,28,147
Steuben,1996,Misdemeanor,0,2,21,43,47,113
Suffolk,1996,Felony,226,191,511,216,156,1300
Suffolk,1996,Misdemeanor,0,209,945,635,722,2511
Sullivan,1996,Felony,13,11,28,38,24,114
Sullivan,1996,Misdemeanor,0,5,21,41,53,120
Tioga,1996,Felony,9,2,12,20,12,55
Tioga,1996,Misdemeanor,0,7,6,33,27,73
Tompkins,1996,Felony,4,8,27,11,16,66
Tompkins,1996,Misdemeanor,0,5,22,64,57,148
Ulster,1996,Felony,15,14,67,19,16,131
Ulster,1996,Misdemeanor,0,48,31,155,147,381
Warren,1996,Felony,4,5,16,20,12,57
Warren,1996,Misdemeanor,0,4,41,65,62,172
Washington,1996,Felony,6,2,24,15,8,55
Washington,1996,Misdemeanor,0,3,14,41,37,95
Wayne,1996,Felony,16,17,55,47,17,152
Wayne,1996,Misdemeanor,0,13,22,53,85,173
Westchester,1996,Felony,142,151,138,110,124,665
Westchester,1996,Misdemeanor,0,228,157,653,637,1675
Wyoming,1996,Felony,3,3,13,35,5,59
Wyoming,1996,Misdemeanor,0,4,11,26,29,70
Yates,1996,Felony,1,0,6,7,1,15
Yates,1996,Misdemeanor,0,0,4,10,11,25
Unknown,1996,Misdemeanor,0,0,0,0,0,0
Albany,1997,Felony,16,85,29,46,50,226
Albany,1997,Misdemeanor,0,121,65,385,480,1051
Allegany,1997,Felony,10,5,9,12,10,46
Allegany,1997,Misdemeanor,0,9,7,29,52,97
Bronx,1997,Felony,479,1219,3,166,233,2100
Bronx,1997,Misdemeanor,0,88,45,197,737,1067
Broome,1997,Felony,64,68,66,129,107,434
Broome,1997,Misdemeanor,0,8,14,115,106,243
Cattaraugus,1997,Felony,0,3,39,22,6,70
Cattaraugus,1997,Misdemeanor,0,6,22,64,67,159
Cayuga,1997,Felony,2,13,11,15,6,47
Cayuga,1997,Misdemeanor,0,7,30,38,51,126
Chautauqua,1997,Felony,15,53,50,42,37,197
Chautauqua,1997,Misdemeanor,0,14,42,98,107,261
Chemung,1997,Felony,20,11,53,21,13,118
Chemung,1997,Misdemeanor,0,5,29,47,38,119
Chenango,1997,Felony,0,0,6,13,6,25
Chenango,1997,Misdemeanor,0,4,10,47,25,86
Clinton,1997,Felony,15,10,36,29,22,112
Clinton,1997,Misdemeanor,0,8,23,89,99,219
Columbia,1997,Felony,2,2,32,7,2,45
Columbia,1997,Misdemeanor,0,11,4,50,74,139
Cortland,1997,Felony,6,4,11,9,7,37
Cortland,1997,Misdemeanor,0,3,15,49,42,109
Delaware,1997,Felony,2,3,4,5,1,15
Delaware,1997,Misdemeanor,0,2,27,43,65,137
Dutchess,1997,Felony,25,55,54,65,35,234
Dutchess,1997,Misdemeanor,0,62,80,210,169,521
Erie,1997,Felony,116,206,225,112,140,799
Erie,1997,Misdemeanor,0,204,285,631,516,1636
Essex,1997,Felony,12,5,12,17,5,51
Essex,1997,Misdemeanor,0,7,12,18,48,85
Franklin,1997,Felony,1,6,7,10,2,26
Franklin,1997,Misdemeanor,0,8,16,48,29,101
Fulton,1997,Felony,7,4,8,27,8,54
Fulton,1997,Misdemeanor,0,5,15,30,26,76
Genesee,1997,Felony,8,7,26,20,23,84
Genesee,1997,Misdemeanor,0,6,26,69,72,173
Greene,1997,Felony,1,0,2,3,1,7
Greene,1997,Misdemeanor,0,4,9,22,20,55
Hamilton,1997,Felony,0,0,2,0,1,3
Hamilton,1997,Misdemeanor,0,1,3,3,0,7
Herkimer,1997,Felony,10,8,10,11,8,47
Herkimer,1997,Misdemeanor,0,1,4,23,21,49
Jefferson,1997,Felony,12,13,9,23,8,65
Jefferson,1997,Misdemeanor,0,10,8,59,68,145
Kings,1997,Felony,655,1103,40,166,420,2384
Kings,1997,Misdemeanor,0,298,163,398,1033,1892
Lewis,1997,Felony,5,2,3,13,4,27
Lewis,1997,Misdemeanor,0,1,3,18,17,39
Livingston,1997,Felony,6,9,30,14,20,79
Livingston,1997,Misdemeanor,0,9,27,48,61,145
Madison,1997,Felony,8,1,28,11,4,52
Madison,1997,Misdemeanor,0,5,25,53,60,143
Monroe,1997,Felony,109,203,170,232,173,887
Monroe,1997,Misdemeanor,0,211,416,646,679,1952
Montgomery,1997,Felony,1,4,10,11,4,30
Montgomery,1997,Misdemeanor,0,7,9,35,46,97
Nassau,1997,Felony,111,318,342,124,151,1046
Nassau,1997,Misdemeanor,0,115,936,578,589,2218
New York,1997,Felony,431,2017,8,315,295,3066
New York,1997,Misdemeanor,0,255,56,363,721,1395
Niagara,1997,Felony,5,26,27,20,19,97
Niagara,1997,Misdemeanor,0,31,109,138,131,409
Oneida,1997,Felony,35,39,79,63,46,262
Oneida,1997,Misdemeanor,0,15,21,113,90,239
Onondaga,1997,Felony,65,94,129,95,94,477
Onondaga,1997,Misdemeanor,0,102,181,369,538,1190
Ontario,1997,Felony,14,8,81,50,14,167
Ontario,1997,Misdemeanor,0,13,17,68,68,166
Orange,1997,Felony,53,81,113,68,54,369
Orange,1997,Misdemeanor,0,138,119,298,294,849
Orleans,1997,Felony,4,7,2,6,1,20
Orleans,1997,Misdemeanor,0,5,42,57,44,148
Oswego,1997,Felony,13,13,29,52,32,139
Oswego,1997,Misdemeanor,0,11,32,68,71,182
Otsego,1997,Felony,1,4,13,3,1,22
Otsego,1997,Misdemeanor,0,7,4,35,23,69
Putnam,1997,Felony,1,9,26,8,9,53
Putnam,1997,Misdemeanor,0,17,38,30,29,114
Queens,1997,Felony,487,677,65,394,369,1992
Queens,1997,Misdemeanor,0,190,19,379,478,1066
Rensselaer,1997,Felony,28,39,30,24,41,162
Rensselaer,1997,Misdemeanor,0,21,31,100,114,266
Richmond,1997,Felony,43,185,5,37,47,317
Richmond,1997,Misdemeanor,0,53,34,103,153,343
Rockland,1997,Felony,36,55,46,51,14,202
Rockland,1997,Misdemeanor,0,34,35,89,94,252
St. Lawrence,1997,Felony,7,10,40,24,17,98
St. Lawrence,1997,Misdemeanor,0,7,13,45,54,119
Saratoga,1997,Felony,10,5,16,12,17,60
Saratoga,1997,Misdemeanor,0,9,28,95,67,199
Schenectady,1997,Felony,10,17,36,30,12,105
Schenectady,1997,Misdemeanor,0,13,20,101,83,217
Schoharie,1997,Felony,0,1,6,4,1,12
Schoharie,1997,Misdemeanor,0,1,6,24,26,57
Schuyler,1997,Felony,2,1,1,5,0,9
Schuyler,1997,Misdemeanor,0,1,12,13,19,45
Seneca,1997,Felony,3,1,15,11,5,35
Seneca,1997,Misdemeanor,0,2,10,14,30,56
Steuben,1997,Felony,30,19,76,48,49,222
Steuben,1997,Misdemeanor,0,4,21,32,45,102
Suffolk,1997,Felony,184,162,489,176,173,1184
Suffolk,1997,Misdemeanor,0,197,1050,737,914,2898
Sullivan,1997,Felony,11,9,34,39,23,116
Sullivan,1997,Misdemeanor,0,7,38,54,51,150
Tioga,1997,Felony,10,8,32,16,10,76
Tioga,1997,Misdemeanor,0,5,9,31,25,70
Tompkins,1997,Felony,7,5,27,13,15,67
Tompkins,1997,Misdemeanor,0,12,38,69,61,180
Ulster,1997,Felony,12,11,56,23,11,113
Ulster,1997,Misdemeanor,0,38,33,125,125,321
Warren,1997,Felony,3,8,13,12,14,50
Warren,1997,Misdemeanor,0,6,24,67,44,141
Washington,1997,Felony,3,2,14,16,9,44
Washington,1997,Misdemeanor,0,10,10,44,30,94
Wayne,1997,Felony,19,13,73,22,28,155
Wayne,1997,Misdemeanor,0,14,24,78,71,187
Westchester,1997,Felony,113,149,133,93,104,592
Westchester,1997,Misdemeanor,0,319,151,697,710,1877
Wyoming,1997,Felony,6,9,8,13,7,43
Wyoming,1997,Misdemeanor,0,1,3,12,17,33
Yates,1997,Felony,1,0,18,1,3,23
Yates,1997,Misdemeanor,0,2,0,13,15,30
Unknown,1997,Misdemeanor,0,0,0,0,0,0
Albany,1998,Felony,13,58,46,50,52,219
Albany,1998,Misdemeanor,0,112,58,387,397,954
Allegany,1998,Felony,8,4,6,5,8,31
Allegany,1998,Misdemeanor,0,6,13,21,55,95
Bronx,1998,Felony,417,1238,8,167,214,2044
Bronx,1998,Misdemeanor,0,90,62,286,902,1340
Broome,1998,Felony,67,67,78,105,71,388
Broome,1998,Misdemeanor,0,14,26,148,131,319
Cattaraugus,1998,Felony,2,14,39,20,9,84
Cattaraugus,1998,Misdemeanor,0,2,18,66,59,145
Cayuga,1998,Felony,0,11,7,16,5,39
Cayuga,1998,Misdemeanor,0,9,30,59,62,160
Chautauqua,1998,Felony,15,44,48,45,35,187
Chautauqua,1998,Misdemeanor,0,10,53,93,115,271
Chemung,1998,Felony,10,8,64,10,15,107
Chemung,1998,Misdemeanor,0,7,34,64,64,169
Chenango,1998,Felony,0,0,3,9,5,17
Chenango,1998,Misdemeanor,0,3,19,38,34,94
Clinton,1998,Felony,14,21,31,25,30,121
Clinton,1998,Misdemeanor,0,15,21,74,123,233
Columbia,1998,Felony,2,1,22,26,11,62
Columbia,1998,Misdemeanor,0,14,4,47,59,124
Cortland,1998,Felony,4,4,18,18,23,67
Cortland,1998,Misdemeanor,0,1,22,47,41,111
Delaware,1998,Felony,1,1,6,6,2,16
Delaware,1998,Misdemeanor,0,5,16,31,69,121
Dutchess,1998,Felony,11,61,38,57,50,217
Dutchess,1998,Misdemeanor,0,35,82,210,165,492
Erie,1998,Felony,146,282,247,114,157,946
Erie,1998,Misdemeanor,0,147,336,558,562,1603
Essex,1998,Felony,5,1,8,6,4,24
Essex,1998,Misdemeanor,0,3,10,22,59,94
Franklin,1998,Felony,0,7,6,4,3,20
Franklin,1998,Misdemeanor,0,15,17,35,53,120
Fulton,1998,Felony,3,2,7,13,8,33
Fulton,1998,Misdemeanor,0,3,8,28,28,67
Genesee,1998,Felony,6,9,48,19,28,110
Genesee,1998,Misdemeanor,0,4,27,52,73,156
Greene,1998,Felony,0,4,6,4,3,17
Greene,1998,Misdemeanor,0,3,8,22,22,55
Hamilton,1998,Felony,0,0,3,0,2,5
Hamilton,1998,Misdemeanor,0,0,0,1,4,5
Herkimer,1998,Felony,17,4,12,15,13,61
Herkimer,1998,Misdemeanor,0,2,4,26,28,60
Jefferson,1998,Felony,11,9,24,20,17,81
Jefferson,1998,Misdemeanor,0,15,21,103,110,249
Kings,1998,Felony,514,821,20,160,358,1873
Kings,1998,Misdemeanor,0,251,204,340,874,1669
Lewis,1998,Felony,1,0,9,24,4,38
Lewis,1998,Misdemeanor,0,0,0,15,13,28
Livingston,1998,Felony,14,7,38,20,15,94
Livingston,1998,Misdemeanor,0,5,18,66,71,160
Madison,1998,Felony,6,5,16,15,9,51
Madison,1998,Misdemeanor,0,8,18,41,45,112
Monroe,1998,Felony,113,222,197,182,152,866
Monroe,1998,Misdemeanor,0,209,483,753,663,2108
Montgomery,1998,Felony,1,3,13,17,7,41
Montgomery,1998,Misdemeanor,0,8,3,31,27,69
Nassau,1998,Felony,130,277,311,119,170,1007
Nassau,1998,Misdemeanor,0,129,796,602,506,2033
New York,1998,Felony,338,1826,7,288,265,2724
New York,1998,Misdemeanor,0,295,62,359,698,1414
Niagara,1998,Felony,5,20,39,25,22,111
Niagara,1998,Misdemeanor,0,29,80,155,160,424
Oneida,1998,Felony,45,36,94,58,55,288
Oneida,1998,Misdemeanor,0,14,29,106,94,243
Onondaga,1998,Felony,46,61,108,84,87,386
Onondaga,1998,Misdemeanor,0,97,144,358,476,1075
Ontario,1998,Felony,11,5,78,43,27,164
Ontario,1998,Misdemeanor,0,14,19,49,66,148
Orange,1998,Felony,41,104,96,72,44,357
Orange,1998,Misdemeanor,0,149,103,320,321,893
Orleans,1998,Felony,2,9,14,7,1,33
Orleans,1998,Misdemeanor,0,7,27,32,41,107
Oswego,1998,Felony,10,9,28,39,27,113
Oswego,1998,Misdemeanor,0,2,21,59,72,154
Otsego,1998,Felony,2,3,23,9,5,42
Otsego,1998,Misdemeanor,0,4,9,26,20,59
Putnam,1998,Felony,3,16,20,13,9,61
Putnam,1998,Misdemeanor,0,18,35,16,25,94
Queens,1998,Felony,488,728,67,318,293,1894
Queens,1998,Misdemeanor,0,212,25,300,414,951
Rensselaer,1998,Felony,31,56,60,29,44,220
Rensselaer,1998,Misdemeanor,0,23,17,83,158,281
Richmond,1998,Felony,46,145,11,26,51,279
Richmond,1998,Misdemeanor,0,79,27,91,162,359
Rockland,1998,Felony,30,74,52,49,28,233
Rockland,1998,Misdemeanor,0,33,41,100,107,281
St. Lawrence,1998,Felony,9,12,44,27,21,113
St. Lawrence,1998,Misdemeanor,0,2,33,48,75,158
Saratoga,1998,Felony,11,9,33,28,23,104
Saratoga,1998,Misdemeanor,0,9,31,75,96,211
Schenectady,1998,Felony,8,32,44,38,30,152
Schenectady,1998,Misdemeanor,0,43,14,90,104,251
Schoharie,1998,Felony,1,1,6,5,0,13
Schoharie,1998,Misdemeanor,0,1,23,35,20,79
Schuyler,1998,Felony,0,2,4,12,3,21
Schuyler,1998,Misdemeanor,0,1,4,9,21,35
Seneca,1998,Felony,2,2,9,11,8,32
Seneca,1998,Misdemeanor,0,1,3,9,31,44
Steuben,1998,Felony,11,15,65,37,37,165
Steuben,1998,Misdemeanor,0,9,30,43,55,137
Suffolk,1998,Felony,209,182,414,170,166,1141
Suffolk,1998,Misdemeanor,0,225,1264,766,990,3245
Sullivan,1998,Felony,11,7,29,25,23,95
Sullivan,1998,Misdemeanor,0,10,28,61,64,163
Tioga,1998,Felony,4,3,32,17,12,68
Tioga,1998,Misdemeanor,0,1,8,32,38,79
Tompkins,1998,Felony,5,9,31,12,17,74
Tompkins,1998,Misdemeanor,0,4,40,58,75,177
Ulster,1998,Felony,11,21,65,39,25,161
Ulster,1998,Misdemeanor,0,54,21,135,133,343
Warren,1998,Felony,6,2,17,11,14,50
Warren,1998,Misdemeanor,0,3,35,75,64,177
Washington,1998,Felony,3,9,22,16,18,68
Washington,1998,Misdemeanor,0,13,19,28,49,109
Wayne,1998,Felony,11,9,56,18,26,120
Wayne,1998,Misdemeanor,0,19,14,96,83,212
Westchester,1998,Felony,123,147,196,132,119,717
Westchester,1998,Misdemeanor,0,306,187,839,742,2074
Wyoming,1998,Felony,3,4,16,8,9,40
Wyoming,1998,Misdemeanor,0,4,10,24,28,66
Yates,1998,Felony,1,0,12,3,3,19
Yates,1998,Misdemeanor,0,3,3,21,15,42
Unknown,1998,Misdemeanor,0,0,0,0,0,0
Albany,1999,Felony,6,78,42,52,73,251
Albany,1999,Misdemeanor,0,105,60,345,315,825
Allegany,1999,Felony,7,3,7,11,6,34
Allegany,1999,Misdemeanor,0,9,7,22,42,80
Bronx,1999,Felony,329,1220,9,133,209,1900
Bronx,1999,Misdemeanor,0,115,45,246,746,1152
Broome,1999,Felony,75,87,85,109,92,448
Broome,1999,Misdemeanor,0,29,35,140,143,347
Cattaraugus,1999,Felony,1,10,57,23,7,98
Cattaraugus,1999,Misdemeanor,0,11,21,59,61,152
Cayuga,1999,Felony,0,16,8,9,4,37
Cayuga,1999,Misdemeanor,0,7,40,61,73,181
Chautauqua,1999,Felony,9,59,53,34,20,175
Chautauqua,1999,Misdemeanor,0,12,59,72,135,278
Chemung,1999,Felony,15,10,49,18,4,96
Chemung,1999,Misdemeanor,0,6,41,64,68,179
Chenango,1999,Felony,3,0,7,6,4,20
Chenango,1999,Misdemeanor,0,1,9,35,25,70
Clinton,1999,Felony,7,6,58,9,34,114
Clinton,1999,Misdemeanor,0,5,23,92,135,255
Columbia,1999,Felony,3,4,19,15,3,44
Columbia,1999,Misdemeanor,0,19,4,38,63,124
Cortland,1999,Felony,6,4,32,15,15,72
Cortland,1999,Misdemeanor,0,1,30,34,43,108
Delaware,1999,Felony,0,2,3,3,3,11
Delaware,1999,Misdemeanor,0,4,9,20,41,74
Dutchess,1999,Felony,12,57,52,54,36,211
Dutchess,1999,Misdemeanor,0,36,113,130,159,438
Erie,1999,Felony,131,194,229,118,186,858
Erie,1999,Misdemeanor,0,171,283,507,469,1430
Essex,1999,Felony,1,2,13,4,8,28
Essex,1999,Misdemeanor,0,4,9,26,46,85
Franklin,1999,Felony,0,5,12,11,7,35
Franklin,1999,Misdemeanor,0,20,19,49,60,148
Fulton,1999,Felony,5,3,3,17,8,36
Fulton,1999,Misdemeanor,0,7,15,31,31,84
Genesee,1999,Felony,15,8,23,18,25,89
Genesee,1999,Misdemeanor,0,4,29,38,74,145
Greene,1999,Felony,0,7,17,2,7,33
Greene,1999,Misdemeanor,0,1,9,39,30,79
Hamilton,1999,Felony,0,0,2,1,0,3
Hamilton,1999,Misdemeanor,0,1,1,5,3,10
Herkimer,1999,Felony,7,4,13,10,9,43
Herkimer,1999,Misdemeanor,0,0,3,15,32,50
Jefferson,1999,Felony,3,25,37,18,18,101
Jefferson,1999,Misdemeanor,0,10,29,93,114,246
Kings,1999,Felony,423,637,23,104,306,1493
Kings,1999,Misdemeanor,0,356,158,272,903,1689
Lewis,1999,Felony,3,5,12,21,2,43
Lewis,1999,Misdemeanor,0,0,5,10,10,25
Livingston,1999,Felony,5,8,36,18,18,85
Livingston,1999,Misdemeanor,0,11,25,52,65,153
Madison,1999,Felony,2,3,10,9,11,35
Madison,1999,Misdemeanor,0,6,19,56,47,128
Monroe,1999,Felony,95,204,146,171,167,783
Monroe,1999,Misdemeanor,0,282,557,715,696,2250
Montgomery,1999,Felony,0,6,12,11,8,37
Montgomery,1999,Misdemeanor,0,5,3,27,27,62
Nassau,1999,Felony,119,203,188,97,138,745
Nassau,1999,Misdemeanor,0,138,563,517,465,1683
New York,1999,Felony,373,1914,15,264,287,2853
New York,1999,Misdemeanor,0,250,60,387,673,1370
Niagara,1999,Felony,6,31,49,34,26,146
Niagara,1999,Misdemeanor,0,35,77,130,140,382
Oneida,1999,Felony,42,42,116,41,39,280
Oneida,1999,Misdemeanor,0,34,25,103,124,286
Onondaga,1999,Felony,77,77,98,93,125,470
Onondaga,1999,Misdemeanor,0,120,166,355,499,1140
Ontario,1999,Felony,8,8,68,27,27,138
Ontario,1999,Misdemeanor,0,20,17,63,82,182
Orange,1999,Felony,28,83,94,87,45,337
Orange,1999,Misdemeanor,0,121,103,247,283,754
Orleans,1999,Felony,1,4,6,7,2,20
Orleans,1999,Misdemeanor,0,6,36,34,23,99
Oswego,1999,Felony,9,11,43,39,41,143
Oswego,1999,Misdemeanor,0,13,26,71,103,213
Otsego,1999,Felony,0,3,13,3,4,23
Otsego,1999,Misdemeanor,0,2,10,20,26,58
Putnam,1999,Felony,1,16,28,8,11,64
Putnam,1999,Misdemeanor,0,23,43,43,53,162
Queens,1999,Felony,472,438,71,199,259,1439
Queens,1999,Misdemeanor,0,141,42,237,497,917
Rensselaer,1999,Felony,37,48,46,27,59,217
Rensselaer,1999,Misdemeanor,0,20,20,98,173,311
Richmond,1999,Felony,38,142,7,29,34,250
Richmond,1999,Misdemeanor,0,85,12,81,125,303
Rockland,1999,Felony,19,53,61,61,47,241
Rockland,1999,Misdemeanor,0,44,43,105,103,295
St. Lawrence,1999,Felony,10,15,45,30,37,137
St. Lawrence,1999,Misdemeanor,0,6,29,54,87,176
Saratoga,1999,Felony,9,9,64,21,21,124
Saratoga,1999,Misdemeanor,0,10,25,71,82,188
Schenectady,1999,Felony,7,33,36,28,24,128
Schenectady,1999,Misdemeanor,0,28,15,95,122,260
Schoharie,1999,Felony,0,1,6,4,0,11
Schoharie,1999,Misdemeanor,0,1,6,10,11,28
Schuyler,1999,Felony,1,2,14,13,2,32
Schuyler,1999,Misdemeanor,0,2,1,5,6,14
Seneca,1999,Felony,4,5,13,12,13,47
Seneca,1999,Misdemeanor,0,3,6,10,30,49
Steuben,1999,Felony,24,14,64,41,45,188
Steuben,1999,Misdemeanor,0,11,20,48,84,163
Suffolk,1999,Felony,177,173,431,165,216,1162
Suffolk,1999,Misdemeanor,0,223,987,626,905,2741
Sullivan,1999,Felony,3,11,30,34,27,105
Sullivan,1999,Misdemeanor,0,7,42,58,83,190
Tioga,1999,Felony,5,2,36,11,13,67
Tioga,1999,Misdemeanor,0,4,8,34,42,88
Tompkins,1999,Felony,5,9,24,9,17,64
Tompkins,1999,Misdemeanor,0,7,26,57,71,161
Ulster,1999,Felony,9,22,79,37,24,171
Ulster,1999,Misdemeanor,0,65,38,139,163,405
Warren,1999,Felony,6,5,40,28,23,102
Warren,1999,Misdemeanor,0,10,36,57,59,162
Washington,1999,Felony,2,5,38,12,11,68
Washington,1999,Misdemeanor,0,7,10,38,60,115
Wayne,1999,Felony,5,13,47,26,15,106
Wayne,1999,Misdemeanor,0,9,31,72,77,189
Westchester,1999,Felony,140,127,143,87,92,589
Westchester,1999,Misdemeanor,0,345,218,782,752,2097
Wyoming,1999,Felony,3,1,20,18,10,52
Wyoming,1999,Misdemeanor,0,4,6,26,34,70
Yates,1999,Felony,4,0,9,10,5,28
Yates,1999,Misdemeanor,0,1,3,9,11,24
Unknown,1999,Misdemeanor,0,0,0,0,0,0
Albany,2000,Felony,0,48,35,52,75,210
Albany,2000,Misdemeanor,0,75,80,313,339,807
Allegany,2000,Felony,11,9,9,9,28,66
Allegany,2000,Misdemeanor,0,10,8,31,57,106
Bronx,2000,Felony,265,1033,11,96,186,1591
Bronx,2000,Misdemeanor,0,86,46,218,603,953
Broome,2000,Felony,47,90,83,77,91,388
Broome,2000,Misdemeanor,0,21,43,140,155,359
Cattaraugus,2000,Felony,0,9,40,28,9,86
Cattaraugus,2000,Misdemeanor,0,7,19,51,62,139
Cayuga,2000,Felony,0,11,10,13,10,44
Cayuga,2000,Misdemeanor,0,13,33,51,77,174
Chautauqua,2000,Felony,24,40,62,44,32,202
Chautauqua,2000,Misdemeanor,0,5,46,63,117,231
Chemung,2000,Felony,8,8,58,25,20,119
Chemung,2000,Misdemeanor,0,7,28,54,86,175
Chenango,2000,Felony,1,1,6,22,11,41
Chenango,2000,Misdemeanor,0,3,2,18,39,62
Clinton,2000,Felony,7,3,54,13,30,107
Clinton,2000,Misdemeanor,0,6,29,64,99,198
Columbia,2000,Felony,0,0,15,9,13,37
Columbia,2000,Misdemeanor,0,22,6,51,49,128
Cortland,2000,Felony,4,10,39,30,13,96
Cortland,2000,Misdemeanor,0,6,33,55,71,165
Delaware,2000,Felony,3,3,2,2,2,12
Delaware,2000,Misdemeanor,0,8,12,35,36,91
Dutchess,2000,Felony,3,51,49,52,55,210
Dutchess,2000,Misdemeanor,0,48,150,132,166,496
Erie,2000,Felony,141,160,228,107,191,827
Erie,2000,Misdemeanor,0,139,295,550,577,1561
Essex,2000,Felony,2,9,11,8,12,42
Essex,2000,Misdemeanor,0,5,8,29,41,83
Franklin,2000,Felony,0,4,5,7,2,18
Franklin,2000,Misdemeanor,0,4,24,48,57,133
Fulton,2000,Felony,3,4,8,14,7,36
Fulton,2000,Misdemeanor,0,5,13,20,36,74
Genesee,2000,Felony,16,11,51,10,10,98
Genesee,2000,Misdemeanor,0,5,30,33,74,142
Greene,2000,Felony,4,2,14,9,5,34
Greene,2000,Misdemeanor,0,7,6,43,31,87
Hamilton,2000,Felony,0,0,4,1,1,6
Hamilton,2000,Misdemeanor,0,0,1,1,3,5
Herkimer,2000,Felony,19,3,15,11,13,61
Herkimer,2000,Misdemeanor,0,2,3,37,38,80
Jefferson,2000,Felony,7,24,24,32,20,107
Jefferson,2000,Misdemeanor,0,6,36,74,88,204
Kings,2000,Felony,478,609,29,120,239,1475
Kings,2000,Misdemeanor,0,289,108,316,696,1409
Lewis,2000,Felony,2,1,11,14,8,36
Lewis,2000,Misdemeanor,0,0,2,11,10,23
Livingston,2000,Felony,12,5,55,19,21,112
Livingston,2000,Misdemeanor,0,15,21,58,83,177
Madison,2000,Felony,5,4,26,1,9,45
Madison,2000,Misdemeanor,0,6,24,35,22,87
Monroe,2000,Felony,75,189,164,142,138,708
Monroe,2000,Misdemeanor,0,260,457,720,601,2038
Montgomery,2000,Felony,0,9,19,14,6,48
Montgomery,2000,Misdemeanor,0,5,13,16,25,59
Nassau,2000,Felony,160,227,194,108,162,851
Nassau,2000,Misdemeanor,0,139,433,486,426,1484
New York,2000,Felony,375,1601,9,300,257,2542
New York,2000,Misdemeanor,0,287,67,436,624,1414
Niagara,2000,Felony,7,54,55,44,31,191
Niagara,2000,Misdemeanor,0,28,91,125,192,436
Oneida,2000,Felony,36,31,78,45,47,237
Oneida,2000,Misdemeanor,0,12,19,114,97,242
Onondaga,2000,Felony,82,54,100,112,96,444
Onondaga,2000,Misdemeanor,0,101,184,306,376,967
Ontario,2000,Felony,14,8,62,38,21,143
Ontario,2000,Misdemeanor,0,16,24,67,78,185
Orange,2000,Felony,24,81,113,86,57,361
Orange,2000,Misdemeanor,0,83,78,193,201,555
Orleans,2000,Felony,5,3,3,7,3,21
Orleans,2000,Misdemeanor,0,6,23,33,25,87
Oswego,2000,Felony,10,6,47,57,44,164
Oswego,2000,Misdemeanor,0,3,36,54,93,186
Otsego,2000,Felony,2,0,14,3,2,21
Otsego,2000,Misdemeanor,0,4,13,21,15,53
Putnam,2000,Felony,1,21,22,14,5,63
Putnam,2000,Misdemeanor,0,18,42,29,31,120
Queens,2000,Felony,453,398,56,247,287,1441
Queens,2000,Misdemeanor,0,151,45,308,490,994
Rensselaer,2000,Felony,25,27,46,36,74,208
Rensselaer,2000,Misdemeanor,0,18,32,93,165,308
Richmond,2000,Felony,21,114,5,27,39,206
Richmond,2000,Misdemeanor,0,54,14,89,134,291
Rockland,2000,Felony,16,43,46,64,45,214
Rockland,2000,Misdemeanor,0,45,36,91,115,287
St. Lawrence,2000,Felony,6,34,31,33,33,137
St. Lawrence,2000,Misdemeanor,0,5,20,51,56,132
Saratoga,2000,Felony,9,10,83,22,26,150
Saratoga,2000,Misdemeanor,0,7,36,64,92,199
Schenectady,2000,Felony,9,16,31,12,16,84
Schenectady,2000,Misdemeanor,0,26,11,109,140,286
Schoharie,2000,Felony,0,0,5,3,1,9
Schoharie,2000,Misdemeanor,0,2,4,25,21,52
Schuyler,2000,Felony,3,0,16,18,3,40
Schuyler,2000,Misdemeanor,0,0,5,9,9,23
Seneca,2000,Felony,2,2,10,23,14,51
Seneca,2000,Misdemeanor,0,3,14,14,23,54
Steuben,2000,Felony,21,20,88,35,37,201
Steuben,2000,Misdemeanor,0,4,21,60,70,155
Suffolk,2000,Felony,122,216,353,160,180,1031
Suffolk,2000,Misdemeanor,0,261,1014,692,973,2940
Sullivan,2000,Felony,3,16,43,32,27,121
Sullivan,2000,Misdemeanor,0,13,51,68,52,184
Tioga,2000,Felony,5,2,22,16,16,61
Tioga,2000,Misdemeanor,0,8,11,41,33,93
Tompkins,2000,Felony,12,10,23,10,17,72
Tompkins,2000,Misdemeanor,0,5,38,28,55,126
Ulster,2000,Felony,7,20,77,36,27,167
Ulster,2000,Misdemeanor,0,47,41,98,109,295
Warren,2000,Felony,7,4,28,18,26,83
Warren,2000,Misdemeanor,0,5,35,55,83,178
Washington,2000,Felony,4,6,19,14,15,58
Washington,2000,Misdemeanor,0,3,7,21,48,79
Wayne,2000,Felony,6,10,63,22,17,118
Wayne,2000,Misdemeanor,0,13,22,66,81,182
Westchester,2000,Felony,99,120,133,92,129,573
Westchester,2000,Misdemeanor,0,333,217,730,670,1950
Wyoming,2000,Felony,10,5,21,12,5,53
Wyoming,2000,Misdemeanor,0,1,11,32,38,82
Yates,2000,Felony,2,1,8,6,10,27
Yates,2000,Misdemeanor,0,1,3,10,19,33
Unknown,2000,Misdemeanor,0,0,0,0,0,0
Albany,2001,Felony,10,86,30,89,110,325
Albany,2001,Misdemeanor,0,91,72,335,350,848
Allegany,2001,Felony,11,3,17,7,8,46
Allegany,2001,Misdemeanor,0,3,11,49,34,97
Bronx,2001,Felony,317,926,10,104,163,1520
Bronx,2001,Misdemeanor,0,105,55,187,574,921
Broome,2001,Felony,51,88,79,62,98,378
Broome,2001,Misdemeanor,0,36,28,100,136,300
Cattaraugus,2001,Felony,2,7,39,21,14,83
Cattaraugus,2001,Misdemeanor,0,8,23,48,80,159
Cayuga,2001,Felony,1,9,6,3,10,29
Cayuga,2001,Misdemeanor,0,6,33,51,65,155
Chautauqua,2001,Felony,35,32,51,41,30,189
Chautauqua,2001,Misdemeanor,0,9,39,64,118,230
Chemung,2001,Felony,9,7,42,24,15,97
Chemung,2001,Misdemeanor,0,16,34,57,98,205
Chenango,2001,Felony,2,2,2,13,5,24
Chenango,2001,Misdemeanor,0,2,2,26,24,54
Clinton,2001,Felony,10,7,33,10,15,75
Clinton,2001,Misdemeanor,0,8,23,63,99,193
Columbia,2001,Felony,1,0,24,14,11,50
Columbia,2001,Misdemeanor,0,26,14,43,60,143
Cortland,2001,Felony,7,5,26,10,10,58
Cortland,2001,Misdemeanor,0,2,20,50,55,127
Delaware,2001,Felony,5,4,10,2,2,23
Delaware,2001,Misdemeanor,0,6,14,25,20,65
Dutchess,2001,Felony,3,59,55,52,43,212
Dutchess,2001,Misdemeanor,0,42,156,140,162,500
Erie,2001,Felony,138,181,243,104,153,819
Erie,2001,Misdemeanor,0,121,367,471,572,1531
Essex,2001,Felony,5,1,10,8,10,34
Essex,2001,Misdemeanor,0,2,14,24,46,86
Franklin,2001,Felony,1,4,3,15,7,30
Franklin,2001,Misdemeanor,0,5,19,44,69,137
Fulton,2001,Felony,1,2,11,13,9,36
Fulton,2001,Misdemeanor,0,3,23,17,40,83
Genesee,2001,Felony,16,3,30,11,17,77
Genesee,2001,Misdemeanor,0,11,23,41,48,123
Greene,2001,Felony,5,4,8,3,4,24
Greene,2001,Misdemeanor,0,5,11,44,29,89
Hamilton,2001,Felony,0,0,2,1,0,3
Hamilton,2001,Misdemeanor,0,0,1,2,2,5
Herkimer,2001,Felony,10,8,9,20,19,66
Herkimer,2001,Misdemeanor,0,5,3,29,39,76
Jefferson,2001,Felony,10,24,28,41,28,131
Jefferson,2001,Misdemeanor,0,10,27,47,56,140
Kings,2001,Felony,514,635,35,99,254,1537
Kings,2001,Misdemeanor,0,311,145,290,801,1547
Lewis,2001,Felony,1,0,5,15,3,24
Lewis,2001,Misdemeanor,0,2,2,16,7,27
Livingston,2001,Felony,17,7,67,22,26,139
Livingston,2001,Misdemeanor,0,9,18,42,68,137
Madison,2001,Felony,2,1,6,2,3,14
Madison,2001,Misdemeanor,0,3,13,39,31,86
Monroe,2001,Felony,83,155,197,124,145,704
Monroe,2001,Misdemeanor,0,254,482,737,496,1969
Montgomery,2001,Felony,0,5,15,15,4,39
Montgomery,2001,Misdemeanor,0,5,6,13,18,42
Nassau,2001,Felony,105,242,155,131,144,777
Nassau,2001,Misdemeanor,0,92,430,493,428,1443
New York,2001,Felony,332,1320,9,248,253,2162
New York,2001,Misdemeanor,0,209,28,376,515,1128
Niagara,2001,Felony,3,36,56,25,37,157
Niagara,2001,Misdemeanor,0,48,75,161,154,438
Oneida,2001,Felony,28,38,81,49,30,226
Oneida,2001,Misdemeanor,0,29,26,119,156,330
Onondaga,2001,Felony,58,60,81,83,101,383
Onondaga,2001,Misdemeanor,0,73,166,337,404,980
Ontario,2001,Felony,7,5,71,22,23,128
Ontario,2001,Misdemeanor,0,28,23,50,100,201
Orange,2001,Felony,35,67,131,103,55,391
Orange,2001,Misdemeanor,0,74,64,228,170,536
Orleans,2001,Felony,0,8,2,7,1,18
Orleans,2001,Misdemeanor,0,11,28,30,29,98
Oswego,2001,Felony,3,7,39,45,49,143
Oswego,2001,Misdemeanor,0,3,37,68,95,203
Otsego,2001,Felony,9,1,21,7,9,47
Otsego,2001,Misdemeanor,0,2,8,27,18,55
Putnam,2001,Felony,0,7,26,10,5,48
Putnam,2001,Misdemeanor,0,8,25,21,29,83
Queens,2001,Felony,416,332,64,223,348,1383
Queens,2001,Misdemeanor,0,123,35,328,543,1029
Rensselaer,2001,Felony,22,49,48,14,40,173
Rensselaer,2001,Misdemeanor,0,16,23,84,164,287
Richmond,2001,Felony,24,70,5,28,24,151
Richmond,2001,Misdemeanor,0,47,13,78,100,238
Rockland,2001,Felony,18,31,56,58,37,200
Rockland,2001,Misdemeanor,0,52,43,78,101,274
St. Lawrence,2001,Felony,10,18,48,32,32,140
St. Lawrence,2001,Misdemeanor,0,12,34,50,64,160
Saratoga,2001,Felony,9,19,59,23,30,140
Saratoga,2001,Misdemeanor,0,19,30,85,104,238
Schenectady,2001,Felony,4,24,21,20,36,105
Schenectady,2001,Misdemeanor,0,20,14,111,137,282
Schoharie,2001,Felony,1,5,10,2,5,23
Schoharie,2001,Misdemeanor,0,4,8,18,22,52
Schuyler,2001,Felony,0,0,15,10,4,29
Schuyler,2001,Misdemeanor,0,1,4,5,16,26
Seneca,2001,Felony,4,5,14,15,15,53
Seneca,2001,Misdemeanor,0,2,5,10,21,38
Steuben,2001,Felony,22,17,58,29,30,156
Steuben,2001,Misdemeanor,0,1,32,44,96,173
Suffolk,2001,Felony,117,146,372,154,192,981
Suffolk,2001,Misdemeanor,0,256,814,566,936,2572
Sullivan,2001,Felony,3,19,42,20,31,115
Sullivan,2001,Misdemeanor,0,16,64,55,58,193
Tioga,2001,Felony,8,5,26,17,23,79
Tioga,2001,Misdemeanor,0,1,16,31,43,91
Tompkins,2001,Felony,7,7,28,15,16,73
Tompkins,2001,Misdemeanor,0,8,67,54,55,184
Ulster,2001,Felony,9,14,78,38,25,164
Ulster,2001,Misdemeanor,0,46,38,131,112,327
Warren,2001,Felony,7,5,30,30,27,99
Warren,2001,Misdemeanor,0,8,44,52,76,180
Washington,2001,Felony,4,2,24,12,11,53
Washington,2001,Misdemeanor,0,6,12,25,42,85
Wayne,2001,Felony,5,7,51,24,17,104
Wayne,2001,Misdemeanor,0,5,23,66,74,168
Westchester,2001,Felony,99,109,119,93,107,527
Westchester,2001,Misdemeanor,0,273,150,634,653,1710
Wyoming,2001,Felony,1,3,17,17,16,54
Wyoming,2001,Misdemeanor,0,4,18,31,43,96
Yates,2001,Felony,2,1,8,13,10,34
Yates,2001,Misdemeanor,0,0,0,10,6,16
Unknown,2001,Misdemeanor,0,0,0,0,0,0
Albany,2002,Felony,7,71,42,129,133,382
Albany,2002,Misdemeanor,0,81,78,345,406,910
Allegany,2002,Felony,3,1,15,9,11,39
Allegany,2002,Misdemeanor,0,2,10,36,32,80
Bronx,2002,Felony,356,716,11,145,271,1499
Bronx,2002,Misdemeanor,0,166,70,215,667,1118
Broome,2002,Felony,48,56,73,68,84,329
Broome,2002,Misdemeanor,0,29,32,137,153,351
Cattaraugus,2002,Felony,3,4,42,37,18,104
Cattaraugus,2002,Misdemeanor,0,12,22,80,92,206
Cayuga,2002,Felony,0,13,4,9,14,40
Cayuga,2002,Misdemeanor,0,9,18,55,59,141
Chautauqua,2002,Felony,22,43,55,42,25,187
Chautauqua,2002,Misdemeanor,0,6,47,60,102,215
Chemung,2002,Felony,12,4,40,22,18,96
Chemung,2002,Misdemeanor,0,11,24,66,75,176
Chenango,2002,Felony,3,1,11,16,4,35
Chenango,2002,Misdemeanor,0,2,6,32,38,78
Clinton,2002,Felony,9,6,21,14,18,68
Clinton,2002,Misdemeanor,0,15,24,84,81,204
Columbia,2002,Felony,5,8,28,18,11,70
Columbia,2002,Misdemeanor,0,39,15,37,74,165
Cortland,2002,Felony,4,2,17,19,7,49
Cortland,2002,Misdemeanor,0,2,33,52,67,154
Delaware,2002,Felony,6,3,7,5,2,23
Delaware,2002,Misdemeanor,0,3,12,26,29,70
Dutchess,2002,Felony,1,54,49,56,42,202
Dutchess,2002,Misdemeanor,0,49,125,151,165,490
Erie,2002,Felony,91,213,285,70,156,815
Erie,2002,Misdemeanor,0,143,354,488,484,1469
Essex,2002,Felony,1,1,9,12,5,28
Essex,2002,Misdemeanor,0,7,15,42,47,111
Franklin,2002,Felony,4,4,15,18,8,49
Franklin,2002,Misdemeanor,0,14,23,41,63,141
Fulton,2002,Felony,0,5,9,11,6,31
Fulton,2002,Misdemeanor,0,1,12,22,39,74
Genesee,2002,Felony,23,2,35,11,16,87
Genesee,2002,Misdemeanor,0,3,17,28,46,94
Greene,2002,Felony,3,2,10,3,6,24
Greene,2002,Misdemeanor,0,8,16,34,34,92
Hamilton,2002,Felony,0,2,3,0,2,7
Hamilton,2002,Misdemeanor,0,0,0,4,5,9
Herkimer,2002,Felony,16,8,21,7,13,65
Herkimer,2002,Misdemeanor,0,3,8,21,29,61
Jefferson,2002,Felony,17,23,23,35,34,132
Jefferson,2002,Misdemeanor,0,17,23,66,76,182
Kings,2002,Felony,480,440,36,130,241,1327
Kings,2002,Misdemeanor,0,255,135,246,712,1348
Lewis,2002,Felony,3,2,1,8,1,15
Lewis,2002,Misdemeanor,0,1,9,9,22,41
Livingston,2002,Felony,5,8,50,22,25,110
Livingston,2002,Misdemeanor,0,16,12,43,48,119
Madison,2002,Felony,2,0,13,6,0,21
Madison,2002,Misdemeanor,0,8,12,53,40,113
Monroe,2002,Felony,87,143,271,159,146,806
Monroe,2002,Misdemeanor,0,191,365,613,436,1605
Montgomery,2002,Felony,0,11,8,20,9,48
Montgomery,2002,Misdemeanor,0,5,5,16,21,47
Nassau,2002,Felony,151,212,169,122,112,766
Nassau,2002,Misdemeanor,0,112,535,477,502,1626
New York,2002,Felony,342,977,13,277,310,1919
New York,2002,Misdemeanor,0,179,24,362,536,1101
Niagara,2002,Felony,11,34,48,26,41,160
Niagara,2002,Misdemeanor,0,35,60,112,163,370
Oneida,2002,Felony,46,30,82,68,42,268
Oneida,2002,Misdemeanor,0,21,15,125,141,302
Onondaga,2002,Felony,63,60,81,94,102,400
Onondaga,2002,Misdemeanor,0,74,119,361,345,899
Ontario,2002,Felony,12,7,45,32,26,122
Ontario,2002,Misdemeanor,0,23,20,66,84,193
Orange,2002,Felony,44,84,147,146,102,523
Orange,2002,Misdemeanor,0,44,71,193,187,495
Orleans,2002,Felony,0,3,2,12,3,20
Orleans,2002,Misdemeanor,0,4,19,26,40,89
Oswego,2002,Felony,2,12,29,36,21,100
Oswego,2002,Misdemeanor,0,9,46,83,83,221
Otsego,2002,Felony,2,0,14,4,9,29
Otsego,2002,Misdemeanor,0,0,7,19,11,37
Putnam,2002,Felony,1,4,12,6,4,27
Putnam,2002,Misdemeanor,0,9,24,31,37,101
Queens,2002,Felony,463,219,57,235,321,1295
Queens,2002,Misdemeanor,0,107,47,334,572,1060
Rensselaer,2002,Felony,19,17,43,16,47,142
Rensselaer,2002,Misdemeanor,0,14,17,88,174,293
Richmond,2002,Felony,23,38,14,33,57,165
Richmond,2002,Misdemeanor,0,30,15,48,80,173
Rockland,2002,Felony,15,27,34,58,42,176
Rockland,2002,Misdemeanor,0,40,44,103,100,287
St. Lawrence,2002,Felony,11,21,55,50,43,180
St. Lawrence,2002,Misdemeanor,0,12,27,51,65,155
Saratoga,2002,Felony,7,12,51,15,40,125
Saratoga,2002,Misdemeanor,0,9,26,96,69,200
Schenectady,2002,Felony,6,4,18,17,22,67
Schenectady,2002,Misdemeanor,0,22,5,131,139,297
Schoharie,2002,Felony,1,2,6,5,9,23
Schoharie,2002,Misdemeanor,0,4,8,19,23,54
Schuyler,2002,Felony,0,1,12,4,0,17
Schuyler,2002,Misdemeanor,0,1,1,8,17,27
Seneca,2002,Felony,3,2,13,10,8,36
Seneca,2002,Misdemeanor,0,2,5,16,25,48
Steuben,2002,Felony,13,4,50,28,48,143
Steuben,2002,Misdemeanor,0,6,22,31,76,135
Suffolk,2002,Felony,125,140,282,150,168,865
Suffolk,2002,Misdemeanor,0,250,853,608,814,2525
Sullivan,2002,Felony,4,20,47,30,19,120
Sullivan,2002,Misdemeanor,0,22,52,54,71,199
Tioga,2002,Felony,5,1,29,33,14,82
Tioga,2002,Misdemeanor,0,9,14,17,45,85
Tompkins,2002,Felony,9,8,22,22,20,81
Tompkins,2002,Misdemeanor,0,10,53,49,67,179
Ulster,2002,Felony,10,21,79,40,25,175
Ulster,2002,Misdemeanor,0,23,34,97,96,250
Warren,2002,Felony,3,10,32,38,22,105
Warren,2002,Misdemeanor,0,14,45,72,75,206
Washington,2002,Felony,1,4,16,13,6,40
Washington,2002,Misdemeanor,0,8,12,19,29,68
Wayne,2002,Felony,17,3,59,45,31,155
Wayne,2002,Misdemeanor,0,10,25,60,82,177
Westchester,2002,Felony,129,101,112,110,93,545
Westchester,2002,Misdemeanor,0,283,127,602,602,1614
Wyoming,2002,Felony,0,3,23,17,8,51
Wyoming,2002,Misdemeanor,0,3,20,20,29,72
Yates,2002,Felony,3,3,5,11,9,31
Yates,2002,Misdemeanor,0,2,1,12,19,34
Unknown,2002,Misdemeanor,0,0,0,0,0,0
Albany,2003,Felony,16,84,19,101,143,363
Albany,2003,Misdemeanor,0,96,68,316,453,933
Allegany,2003,Felony,5,2,6,12,6,31
Allegany,2003,Misdemeanor,0,2,7,19,37,65
Bronx,2003,Felony,320,610,29,116,251,1326
Bronx,2003,Misdemeanor,0,188,62,225,702,1177
Broome,2003,Felony,54,64,64,55,73,310
Broome,2003,Misdemeanor,0,17,28,136,152,333
Cattaraugus,2003,Felony,0,3,40,36,8,87
Cattaraugus,2003,Misdemeanor,0,7,22,56,94,179
Cayuga,2003,Felony,2,14,1,13,8,38
Cayuga,2003,Misdemeanor,0,8,41,44,48,141
Chautauqua,2003,Felony,13,45,70,36,22,186
Chautauqua,2003,Misdemeanor,0,19,26,58,109,212
Chemung,2003,Felony,10,3,28,21,12,74
Chemung,2003,Misdemeanor,0,12,23,76,86,197
Chenango,2003,Felony,6,7,6,8,7,34
Chenango,2003,Misdemeanor,0,2,5,27,21,55
Clinton,2003,Felony,2,8,22,10,13,55
Clinton,2003,Misdemeanor,0,11,21,67,78,177
Columbia,2003,Felony,4,6,18,27,18,73
Columbia,2003,Misdemeanor,0,19,7,29,44,99
Cortland,2003,Felony,4,8,26,12,9,59
Cortland,2003,Misdemeanor,0,4,36,53,69,162
Delaware,2003,Felony,6,7,3,6,5,27
Delaware,2003,Misdemeanor,0,3,8,27,33,71
Dutchess,2003,Felony,8,65,43,52,42,210
Dutchess,2003,Misdemeanor,0,49,137,116,151,453
Erie,2003,Felony,102,166,308,99,172,847
Erie,2003,Misdemeanor,0,129,409,434,479,1451
Essex,2003,Felony,0,6,8,6,3,23
Essex,2003,Misdemeanor,0,3,17,40,46,106
Franklin,2003,Felony,1,13,11,17,12,54
Franklin,2003,Misdemeanor,0,21,29,31,69,150
Fulton,2003,Felony,3,4,3,10,13,33
Fulton,2003,Misdemeanor,0,5,16,28,39,88
Genesee,2003,Felony,11,4,36,10,22,83
Genesee,2003,Misdemeanor,0,6,23,36,44,109
Greene,2003,Felony,2,5,12,10,10,39
Greene,2003,Misdemeanor,0,8,18,23,32,81
Hamilton,2003,Felony,0,0,1,1,0,2
Hamilton,2003,Misdemeanor,0,0,1,3,2,6
Herkimer,2003,Felony,14,8,13,21,11,67
Herkimer,2003,Misdemeanor,0,4,3,24,43,74
Jefferson,2003,Felony,23,32,37,42,31,165
Jefferson,2003,Misdemeanor,0,10,17,64,70,161
Kings,2003,Felony,379,376,42,108,215,1120
Kings,2003,Misdemeanor,0,174,122,191,520,1007
Lewis,2003,Felony,0,0,6,22,7,35
Lewis,2003,Misdemeanor,0,0,4,9,9,22
Livingston,2003,Felony,7,3,58,37,13,118
Livingston,2003,Misdemeanor,0,9,17,46,53,125
Madison,2003,Felony,3,4,18,4,2,31
Madison,2003,Misdemeanor,0,11,21,43,43,118
Monroe,2003,Felony,93,127,218,132,93,663
Monroe,2003,Misdemeanor,0,194,328,630,496,1648
Montgomery,2003,Felony,2,5,15,12,10,44
Montgomery,2003,Misdemeanor,0,2,6,22,13,43
Nassau,2003,Felony,152,261,166,132,143,854
Nassau,2003,Misdemeanor,0,146,802,446,605,1999
New York,2003,Felony,301,822,7,331,244,1705
New York,2003,Misdemeanor,0,195,27,343,447,1012
Niagara,2003,Felony,6,29,57,34,36,162
Niagara,2003,Misdemeanor,0,29,102,111,150,392
Oneida,2003,Felony,30,29,69,49,50,227
Oneida,2003,Misdemeanor,0,22,14,121,156,313
Onondaga,2003,Felony,67,56,77,130,73,403
Onondaga,2003,Misdemeanor,0,75,102,332,370,879
Ontario,2003,Felony,15,7,45,38,39,144
Ontario,2003,Misdemeanor,0,19,27,53,82,181
Orange,2003,Felony,42,90,125,108,82,447
Orange,2003,Misdemeanor,0,53,59,174,163,449
Orleans,2003,Felony,0,3,3,9,1,16
Orleans,2003,Misdemeanor,0,9,21,26,23,79
Oswego,2003,Felony,0,3,31,46,20,100
Oswego,2003,Misdemeanor,0,13,48,59,75,195
Otsego,2003,Felony,1,0,22,2,4,29
Otsego,2003,Misdemeanor,0,5,8,28,17,58
Putnam,2003,Felony,0,6,10,8,9,33
Putnam,2003,Misdemeanor,0,13,32,32,37,114
Queens,2003,Felony,457,197,77,267,342,1340
Queens,2003,Misdemeanor,0,103,42,307,498,950
Rensselaer,2003,Felony,15,34,29,37,37,152
Rensselaer,2003,Misdemeanor,0,14,18,89,185,306
Richmond,2003,Felony,19,51,1,37,27,135
Richmond,2003,Misdemeanor,0,32,12,55,60,159
Rockland,2003,Felony,24,48,42,32,35,181
Rockland,2003,Misdemeanor,0,44,36,70,90,240
St. Lawrence,2003,Felony,13,12,44,56,57,182
St. Lawrence,2003,Misdemeanor,0,12,23,49,71,155
Saratoga,2003,Felony,8,18,72,26,43,167
Saratoga,2003,Misdemeanor,0,13,28,89,95,225
Schenectady,2003,Felony,4,26,18,13,28,89
Schenectady,2003,Misdemeanor,0,21,19,118,138,296
Schoharie,2003,Felony,3,4,11,12,4,34
Schoharie,2003,Misdemeanor,0,3,10,15,19,47
Schuyler,2003,Felony,0,1,5,6,7,19
Schuyler,2003,Misdemeanor,0,2,4,3,12,21
Seneca,2003,Felony,1,6,8,8,10,33
Seneca,2003,Misdemeanor,0,5,3,26,35,69
Steuben,2003,Felony,17,10,57,33,31,148
Steuben,2003,Misdemeanor,0,6,18,28,70,122
Suffolk,2003,Felony,139,153,258,137,185,872
Suffolk,2003,Misdemeanor,0,212,948,593,838,2591
Sullivan,2003,Felony,6,16,26,25,24,97
Sullivan,2003,Misdemeanor,0,13,50,53,68,184
Tioga,2003,Felony,3,1,27,14,15,60
Tioga,2003,Misdemeanor,0,6,7,14,35,62
Tompkins,2003,Felony,17,7,18,14,18,74
Tompkins,2003,Misdemeanor,0,10,56,51,65,182
Ulster,2003,Felony,15,25,66,46,28,180
Ulster,2003,Misdemeanor,0,22,33,75,79,209
Warren,2003,Felony,4,10,28,25,20,87
Warren,2003,Misdemeanor,0,24,39,59,85,207
Washington,2003,Felony,4,2,8,7,6,27
Washington,2003,Misdemeanor,0,6,12,30,44,92
Wayne,2003,Felony,18,11,66,22,25,142
Wayne,2003,Misdemeanor,0,14,19,65,83,181
Westchester,2003,Felony,106,107,132,105,105,555
Westchester,2003,Misdemeanor,0,277,170,623,674,1744
Wyoming,2003,Felony,2,8,11,17,9,47
Wyoming,2003,Misdemeanor,0,3,10,21,40,74
Yates,2003,Felony,0,0,13,2,5,20
Yates,2003,Misdemeanor,0,5,6,12,23,46
Unknown,2003,Misdemeanor,0,0,0,0,0,0
Albany,2004,Felony,6,91,21,64,110,292
Albany,2004,Misdemeanor,0,97,69,304,377,847
Allegany,2004,Felony,7,2,19,6,7,41
Allegany,2004,Misdemeanor,0,3,15,31,21,70
Bronx,2004,Felony,340,545,18,113,235,1251
Bronx,2004,Misdemeanor,0,195,72,193,646,1106
Broome,2004,Felony,58,54,63,48,85,308
Broome,2004,Misdemeanor,0,13,24,115,167,319
Cattaraugus,2004,Felony,1,4,36,35,21,97
Cattaraugus,2004,Misdemeanor,0,14,32,54,70,170
Cayuga,2004,Felony,1,18,4,9,13,45
Cayuga,2004,Misdemeanor,0,7,32,59,77,175
Chautauqua,2004,Felony,19,46,61,39,32,197
Chautauqua,2004,Misdemeanor,0,11,36,49,101,197
Chemung,2004,Felony,4,3,23,41,19,90
Chemung,2004,Misdemeanor,0,13,41,67,68,189
Chenango,2004,Felony,1,1,17,26,11,56
Chenango,2004,Misdemeanor,0,2,3,22,22,49
Clinton,2004,Felony,4,17,35,13,20,89
Clinton,2004,Misdemeanor,0,16,34,56,91,197
Columbia,2004,Felony,1,7,27,26,12,73
Columbia,2004,Misdemeanor,0,16,2,36,35,89
Cortland,2004,Felony,2,11,24,21,18,76
Cortland,2004,Misdemeanor,0,10,31,31,51,123
Delaware,2004,Felony,5,5,8,4,0,22
Delaware,2004,Misdemeanor,0,4,10,28,17,59
Dutchess,2004,Felony,7,42,28,58,31,166
Dutchess,2004,Misdemeanor,0,44,123,133,170,470
Erie,2004,Felony,133,131,299,118,193,874
Erie,2004,Misdemeanor,0,142,285,386,479,1292
Essex,2004,Felony,2,7,7,6,5,27
Essex,2004,Misdemeanor,0,6,15,32,41,94
Franklin,2004,Felony,3,20,3,15,14,55
Franklin,2004,Misdemeanor,0,7,38,46,60,151
Fulton,2004,Felony,3,0,8,8,6,25
Fulton,2004,Misdemeanor,0,2,10,14,28,54
Genesee,2004,Felony,15,12,33,13,29,102
Genesee,2004,Misdemeanor,0,4,18,30,51,103
Greene,2004,Felony,4,3,13,4,5,29
Greene,2004,Misdemeanor,0,3,13,33,36,85
Hamilton,2004,Felony,0,0,0,0,0,0
Hamilton,2004,Misdemeanor,0,0,0,2,6,8
Herkimer,2004,Felony,21,7,15,25,17,85
Herkimer,2004,Misdemeanor,0,3,5,27,35,70
Jefferson,2004,Felony,22,25,19,58,40,164
Jefferson,2004,Misdemeanor,0,21,28,65,101,215
Kings,2004,Felony,382,294,41,116,225,1058
Kings,2004,Misdemeanor,0,104,82,136,408,730
Lewis,2004,Felony,5,1,3,5,4,18
Lewis,2004,Misdemeanor,0,4,6,8,13,31
Livingston,2004,Felony,6,8,58,20,21,113
Livingston,2004,Misdemeanor,0,13,11,35,42,101
Madison,2004,Felony,2,2,17,4,1,26
Madison,2004,Misdemeanor,0,6,23,40,40,109
Monroe,2004,Felony,105,116,145,169,118,653
Monroe,2004,Misdemeanor,0,228,382,623,604,1837
Montgomery,2004,Felony,0,10,13,21,15,59
Montgomery,2004,Misdemeanor,0,3,8,19,26,56
Nassau,2004,Felony,126,188,167,106,113,700
Nassau,2004,Misdemeanor,0,95,801,358,460,1714
New York,2004,Felony,283,774,16,265,273,1611
New York,2004,Misdemeanor,0,165,46,316,503,1030
Niagara,2004,Felony,5,46,60,26,28,165
Niagara,2004,Misdemeanor,0,23,92,121,117,353
Oneida,2004,Felony,24,39,64,52,29,208
Oneida,2004,Misdemeanor,0,26,20,137,134,317
Onondaga,2004,Felony,72,77,64,101,111,425
Onondaga,2004,Misdemeanor,0,76,94,311,360,841
Ontario,2004,Felony,16,8,46,29,34,133
Ontario,2004,Misdemeanor,0,14,20,48,100,182
Orange,2004,Felony,39,96,115,89,91,430
Orange,2004,Misdemeanor,0,51,73,166,178,468
Orleans,2004,Felony,4,5,0,14,5,28
Orleans,2004,Misdemeanor,0,16,16,17,26,75
Oswego,2004,Felony,0,9,25,42,26,102
Oswego,2004,Misdemeanor,0,8,50,69,95,222
Otsego,2004,Felony,2,2,8,5,5,22
Otsego,2004,Misdemeanor,0,0,7,25,22,54
Putnam,2004,Felony,3,5,10,11,6,35
Putnam,2004,Misdemeanor,0,6,44,18,22,90
Queens,2004,Felony,472,219,94,261,269,1315
Queens,2004,Misdemeanor,0,127,75,279,486,967
Rensselaer,2004,Felony,21,44,23,35,39,162
Rensselaer,2004,Misdemeanor,0,27,20,112,184,343
Richmond,2004,Felony,31,30,11,33,51,156
Richmond,2004,Misdemeanor,0,34,39,44,86,203
Rockland,2004,Felony,18,55,59,54,52,238
Rockland,2004,Misdemeanor,0,46,44,65,79,234
St. Lawrence,2004,Felony,13,26,41,53,46,179
St. Lawrence,2004,Misdemeanor,0,14,18,61,71,164
Saratoga,2004,Felony,2,21,61,25,31,140
Saratoga,2004,Misdemeanor,0,13,27,69,79,188
Schenectady,2004,Felony,9,39,32,22,30,132
Schenectady,2004,Misdemeanor,0,25,11,113,128,277
Schoharie,2004,Felony,2,2,21,10,3,38
Schoharie,2004,Misdemeanor,0,0,4,15,20,39
Schuyler,2004,Felony,2,4,6,6,8,26
Schuyler,2004,Misdemeanor,0,3,7,9,23,42
Seneca,2004,Felony,4,4,34,7,21,70
Seneca,2004,Misdemeanor,0,3,2,13,22,40
Steuben,2004,Felony,13,12,59,46,43,173
Steuben,2004,Misdemeanor,0,10,29,38,104,181
Suffolk,2004,Felony,159,180,238,146,223,946
Suffolk,2004,Misdemeanor,0,231,1050,565,824,2670
Sullivan,2004,Felony,10,20,37,30,19,116
Sullivan,2004,Misdemeanor,0,9,54,59,83,205
Tioga,2004,Felony,2,3,23,19,10,57
Tioga,2004,Misdemeanor,0,9,7,19,35,70
Tompkins,2004,Felony,12,3,23,7,13,58
Tompkins,2004,Misdemeanor,0,14,55,41,66,176
Ulster,2004,Felony,12,22,72,43,30,179
Ulster,2004,Misdemeanor,0,33,23,83,96,235
Warren,2004,Felony,4,10,34,24,13,85
Warren,2004,Misdemeanor,0,16,30,52,76,174
Washington,2004,Felony,3,1,6,7,13,30
Washington,2004,Misdemeanor,0,9,15,33,53,110
Wayne,2004,Felony,15,15,57,13,20,120
Wayne,2004,Misdemeanor,0,8,26,60,77,171
Westchester,2004,Felony,151,162,118,84,97,612
Westchester,2004,Misdemeanor,0,259,176,505,640,1580
Wyoming,2004,Felony,0,1,5,16,7,29
Wyoming,2004,Misdemeanor,0,9,16,11,28,64
Yates,2004,Felony,1,3,16,13,8,41
Yates,2004,Misdemeanor,0,1,3,18,28,50
Unknown,2004,Misdemeanor,0,0,0,0,0,0
Albany,2005,Felony,12,101,30,55,69,267
Albany,2005,Misdemeanor,0,85,44,259,328,716
Allegany,2005,Felony,6,5,5,5,4,25
Allegany,2005,Misdemeanor,0,7,3,23,32,65
Bronx,2005,Felony,317,577,30,101,213,1238
Bronx,2005,Misdemeanor,0,122,64,178,625,989
Broome,2005,Felony,55,67,71,60,82,335
Broome,2005,Misdemeanor,0,28,26,109,154,317
Cattaraugus,2005,Felony,0,13,36,31,19,99
Cattaraugus,2005,Misdemeanor,0,16,25,57,80,178
Cayuga,2005,Felony,0,16,4,4,10,34
Cayuga,2005,Misdemeanor,0,9,36,61,71,177
Chautauqua,2005,Felony,14,56,41,45,24,180
Chautauqua,2005,Misdemeanor,0,9,15,52,88,164
Chemung,2005,Felony,1,10,37,22,12,82
Chemung,2005,Misdemeanor,0,25,36,70,81,212
Chenango,2005,Felony,1,5,9,18,13,46
Chenango,2005,Misdemeanor,0,9,9,25,31,74
Clinton,2005,Felony,1,10,21,27,17,76
Clinton,2005,Misdemeanor,0,11,22,59,109,201
Columbia,2005,Felony,2,4,25,26,13,70
Columbia,2005,Misdemeanor,0,13,2,26,35,76
Cortland,2005,Felony,4,8,12,14,17,55
Cortland,2005,Misdemeanor,0,7,25,32,79,143
Delaware,2005,Felony,1,4,10,7,4,26
Delaware,2005,Misdemeanor,0,4,16,21,22,63
Dutchess,2005,Felony,5,35,46,49,33,168
Dutchess,2005,Misdemeanor,0,42,139,119,154,454
Erie,2005,Felony,122,124,247,110,143,746
Erie,2005,Misdemeanor,0,110,173,261,290,834
Essex,2005,Felony,3,10,7,6,5,31
Essex,2005,Misdemeanor,0,4,10,21,42,77
Franklin,2005,Felony,3,15,9,15,15,57
Franklin,2005,Misdemeanor,0,10,28,34,62,134
Fulton,2005,Felony,0,1,5,11,8,25
Fulton,2005,Misdemeanor,0,8,11,23,28,70
Genesee,2005,Felony,12,15,41,10,18,96
Genesee,2005,Misdemeanor,0,12,22,44,67,145
Greene,2005,Felony,1,2,17,8,5,33
Greene,2005,Misdemeanor,0,11,16,25,39,91
Hamilton,2005,Felony,0,0,2,0,1,3
Hamilton,2005,Misdemeanor,0,2,2,3,5,12
Herkimer,2005,Felony,14,12,26,18,24,94
Herkimer,2005,Misdemeanor,0,8,3,17,42,70
Jefferson,2005,Felony,17,30,14,61,39,161
Jefferson,2005,Misdemeanor,0,17,16,74,80,187
Kings,2005,Felony,272,231,38,82,188,811
Kings,2005,Misdemeanor,0,85,68,122,335,610
Lewis,2005,Felony,7,3,5,13,7,35
Lewis,2005,Misdemeanor,0,7,2,14,16,39
Livingston,2005,Felony,2,5,36,13,27,83
Livingston,2005,Misdemeanor,0,16,15,33,41,105
Madison,2005,Felony,2,1,15,6,2,26
Madison,2005,Misdemeanor,0,11,20,40,44,115
Monroe,2005,Felony,132,110,172,139,134,687
Monroe,2005,Misdemeanor,0,172,336,594,512,1614
Montgomery,2005,Felony,4,13,21,15,9,62
Montgomery,2005,Misdemeanor,0,4,8,12,28,52
Nassau,2005,Felony,132,226,141,78,136,713
Nassau,2005,Misdemeanor,0,103,910,410,603,2026
New York,2005,Felony,271,722,10,240,268,1511
New York,2005,Misdemeanor,0,146,49,324,443,962
Niagara,2005,Felony,6,25,48,22,55,156
Niagara,2005,Misdemeanor,0,30,68,123,125,346
Oneida,2005,Felony,29,40,35,46,38,188
Oneida,2005,Misdemeanor,0,35,23,150,145,353
Onondaga,2005,Felony,95,104,98,108,123,528
Onondaga,2005,Misdemeanor,0,76,136,294,366,872
Ontario,2005,Felony,12,7,58,45,25,147
Ontario,2005,Misdemeanor,0,13,26,44,72,155
Orange,2005,Felony,36,84,113,104,78,415
Orange,2005,Misdemeanor,0,62,68,152,180,462
Orleans,2005,Felony,0,7,2,3,5,17
Orleans,2005,Misdemeanor,0,7,17,19,36,79
Oswego,2005,Felony,0,7,21,32,20,80
Oswego,2005,Misdemeanor,0,9,43,81,87,220
Otsego,2005,Felony,1,1,5,2,3,12
Otsego,2005,Misdemeanor,0,3,7,19,17,46
Putnam,2005,Felony,1,6,11,6,3,27
Putnam,2005,Misdemeanor,0,18,41,22,22,103
Queens,2005,Felony,413,249,114,192,298,1266
Queens,2005,Misdemeanor,0,145,53,330,485,1013
Rensselaer,2005,Felony,12,51,23,33,34,153
Rensselaer,2005,Misdemeanor,0,20,21,91,160,292
Richmond,2005,Felony,35,43,8,26,47,159
Richmond,2005,Misdemeanor,0,32,49,80,86,247
Rockland,2005,Felony,17,48,54,44,53,216
Rockland,2005,Misdemeanor,0,24,46,49,66,185
St. Lawrence,2005,Felony,15,16,20,23,40,114
St. Lawrence,2005,Misdemeanor,0,20,19,70,88,197
Saratoga,2005,Felony,9,11,71,18,26,135
Saratoga,2005,Misdemeanor,0,20,27,81,76,204
Schenectady,2005,Felony,8,27,30,17,28,110
Schenectady,2005,Misdemeanor,0,41,22,98,148,309
Schoharie,2005,Felony,4,4,8,4,8,28
Schoharie,2005,Misdemeanor,0,3,2,17,17,39
Schuyler,2005,Felony,2,0,5,4,2,13
Schuyler,2005,Misdemeanor,0,1,3,11,12,27
Seneca,2005,Felony,2,2,26,15,5,50
Seneca,2005,Misdemeanor,0,1,4,21,20,46
Steuben,2005,Felony,23,15,34,34,46,152
Steuben,2005,Misdemeanor,0,9,23,46,96,174
Suffolk,2005,Felony,106,212,243,137,157,855
Suffolk,2005,Misdemeanor,0,214,947,543,864,2568
Sullivan,2005,Felony,13,26,54,39,28,160
Sullivan,2005,Misdemeanor,0,20,58,46,48,172
Tioga,2005,Felony,9,5,27,30,19,90
Tioga,2005,Misdemeanor,0,10,10,24,54,98
Tompkins,2005,Felony,7,7,23,32,25,94
Tompkins,2005,Misdemeanor,0,9,58,45,57,169
Ulster,2005,Felony,13,17,75,27,28,160
Ulster,2005,Misdemeanor,0,27,36,104,75,242
Warren,2005,Felony,3,8,43,27,24,105
Warren,2005,Misdemeanor,0,13,39,49,67,168
Washington,2005,Felony,1,3,16,5,9,34
Washington,2005,Misdemeanor,0,9,12,21,56,98
Wayne,2005,Felony,18,21,58,17,20,134
Wayne,2005,Misdemeanor,0,14,23,66,49,152
Westchester,2005,Felony,137,132,143,82,112,606
Westchester,2005,Misdemeanor,0,319,157,575,715,1766
Wyoming,2005,Felony,1,6,11,10,3,31
Wyoming,2005,Misdemeanor,0,8,19,19,33,79
Yates,2005,Felony,0,2,8,14,14,38
Yates,2005,Misdemeanor,0,2,4,11,14,31
Unknown,2005,Misdemeanor,0,0,0,0,0,0
Albany,2006,Felony,13,83,60,66,77,299
Albany,2006,Misdemeanor,0,92,50,247,320,709
Allegany,2006,Felony,6,10,12,10,5,43
Allegany,2006,Misdemeanor,0,5,5,16,36,62
Bronx,2006,Felony,293,472,26,86,231,1108
Bronx,2006,Misdemeanor,0,106,46,155,424,731
Broome,2006,Felony,62,54,67,50,61,294
Broome,2006,Misdemeanor,0,29,29,96,164,318
Cattaraugus,2006,Felony,2,11,41,49,16,119
Cattaraugus,2006,Misdemeanor,0,15,21,50,62,148
Cayuga,2006,Felony,1,15,2,12,9,39
Cayuga,2006,Misdemeanor,0,5,44,63,93,205
Chautauqua,2006,Felony,9,67,32,58,31,197
Chautauqua,2006,Misdemeanor,0,19,27,43,81,170
Chemung,2006,Felony,4,6,35,23,17,85
Chemung,2006,Misdemeanor,0,18,28,53,65,164
Chenango,2006,Felony,5,3,12,11,21,52
Chenango,2006,Misdemeanor,0,4,7,37,38,86
Clinton,2006,Felony,3,7,29,17,13,69
Clinton,2006,Misdemeanor,0,7,30,57,81,175
Columbia,2006,Felony,1,2,15,12,9,39
Columbia,2006,Misdemeanor,0,19,2,20,43,84
Cortland,2006,Felony,6,4,25,18,18,71
Cortland,2006,Misdemeanor,0,4,27,39,54,124
Delaware,2006,Felony,2,8,8,9,7,34
Delaware,2006,Misdemeanor,0,3,9,23,24,59
Dutchess,2006,Felony,5,49,61,61,59,235
Dutchess,2006,Misdemeanor,0,36,143,116,154,449
Erie,2006,Felony,141,158,274,108,142,823
Erie,2006,Misdemeanor,0,107,142,190,268,707
Essex,2006,Felony,1,2,4,3,3,13
Essex,2006,Misdemeanor,0,8,14,18,33,73
Franklin,2006,Felony,4,10,6,40,11,71
Franklin,2006,Misdemeanor,0,14,29,28,71,142
Fulton,2006,Felony,2,4,7,9,7,29
Fulton,2006,Misdemeanor,0,7,11,26,26,70
Genesee,2006,Felony,13,5,50,15,15,98
Genesee,2006,Misdemeanor,0,15,19,30,52,116
Greene,2006,Felony,3,4,13,9,5,34
Greene,2006,Misdemeanor,0,5,13,34,28,80
Hamilton,2006,Felony,0,1,0,0,1,2
Hamilton,2006,Misdemeanor,0,0,0,6,2,8
Herkimer,2006,Felony,20,10,17,19,15,81
Herkimer,2006,Misdemeanor,0,8,0,21,38,67
Jefferson,2006,Felony,16,21,14,61,39,151
Jefferson,2006,Misdemeanor,0,12,16,75,122,225
Kings,2006,Felony,431,223,80,86,264,1084
Kings,2006,Misdemeanor,0,94,65,138,302,599
Lewis,2006,Felony,5,4,4,13,11,37
Lewis,2006,Misdemeanor,0,0,6,19,14,39
Livingston,2006,Felony,3,3,52,19,23,100
Livingston,2006,Misdemeanor,0,11,20,49,63,143
Madison,2006,Felony,0,0,14,3,4,21
Madison,2006,Misdemeanor,0,15,16,48,51,130
Monroe,2006,Felony,126,105,171,159,114,675
Monroe,2006,Misdemeanor,0,175,330,628,492,1625
Montgomery,2006,Felony,2,11,24,9,14,60
Montgomery,2006,Misdemeanor,0,5,12,21,23,61
Nassau,2006,Felony,162,199,160,128,139,788
Nassau,2006,Misdemeanor,0,122,1237,447,527,2333
New York,2006,Felony,268,637,16,228,279,1428
New York,2006,Misdemeanor,0,138,46,253,383,820
Niagara,2006,Felony,12,30,34,19,33,128
Niagara,2006,Misdemeanor,0,39,95,92,132,358
Oneida,2006,Felony,15,37,58,41,42,193
Oneida,2006,Misdemeanor,0,36,29,153,147,365
Onondaga,2006,Felony,86,113,56,107,102,464
Onondaga,2006,Misdemeanor,0,101,145,275,391,912
Ontario,2006,Felony,10,8,47,54,44,163
Ontario,2006,Misdemeanor,0,10,17,56,116,199
Orange,2006,Felony,40,69,114,89,74,386
Orange,2006,Misdemeanor,0,56,80,138,171,445
Orleans,2006,Felony,2,3,4,4,2,15
Orleans,2006,Misdemeanor,0,8,20,21,28,77
Oswego,2006,Felony,0,4,21,30,43,98
Oswego,2006,Misdemeanor,0,11,50,64,68,193
Otsego,2006,Felony,0,9,14,7,5,35
Otsego,2006,Misdemeanor,0,5,3,23,12,43
Putnam,2006,Felony,0,1,14,12,11,38
Putnam,2006,Misdemeanor,0,8,36,22,28,94
Queens,2006,Felony,370,184,100,155,268,1077
Queens,2006,Misdemeanor,0,105,48,307,463,923
Rensselaer,2006,Felony,7,51,45,32,39,174
Rensselaer,2006,Misdemeanor,0,15,33,109,218,375
Richmond,2006,Felony,52,45,7,24,42,170
Richmond,2006,Misdemeanor,0,50,60,100,102,312
Rockland,2006,Felony,32,77,63,55,54,281
Rockland,2006,Misdemeanor,0,31,72,54,80,237
St. Lawrence,2006,Felony,15,19,30,22,27,113
St. Lawrence,2006,Misdemeanor,0,17,21,75,71,184
Saratoga,2006,Felony,3,15,78,14,27,137
Saratoga,2006,Misdemeanor,0,34,34,76,88,232
Schenectady,2006,Felony,7,25,29,42,25,128
Schenectady,2006,Misdemeanor,0,35,22,141,146,344
Schoharie,2006,Felony,0,11,9,3,5,28
Schoharie,2006,Misdemeanor,0,12,2,10,14,38
Schuyler,2006,Felony,1,5,6,13,3,28
Schuyler,2006,Misdemeanor,0,2,3,9,9,23
Seneca,2006,Felony,4,6,23,11,2,46
Seneca,2006,Misdemeanor,0,0,10,15,28,53
Steuben,2006,Felony,17,28,46,45,54,190
Steuben,2006,Misdemeanor,0,6,14,35,78,133
Suffolk,2006,Felony,189,177,286,194,199,1045
Suffolk,2006,Misdemeanor,0,207,1155,552,800,2714
Sullivan,2006,Felony,9,19,44,43,33,148
Sullivan,2006,Misdemeanor,0,18,41,42,57,158
Tioga,2006,Felony,7,2,28,23,11,71
Tioga,2006,Misdemeanor,0,10,6,25,33,74
Tompkins,2006,Felony,13,5,19,14,26,77
Tompkins,2006,Misdemeanor,0,7,45,39,69,160
Ulster,2006,Felony,10,26,67,15,33,151
Ulster,2006,Misdemeanor,0,25,36,82,74,217
Warren,2006,Felony,3,8,40,29,31,111
Warren,2006,Misdemeanor,0,16,28,69,70,183
Washington,2006,Felony,3,3,16,12,18,52
Washington,2006,Misdemeanor,0,26,21,32,77,156
Wayne,2006,Felony,33,8,32,15,22,110
Wayne,2006,Misdemeanor,0,13,10,54,61,138
Westchester,2006,Felony,98,119,158,73,111,559
Westchester,2006,Misdemeanor,0,314,217,490,564,1585
Wyoming,2006,Felony,3,5,5,8,14,35
Wyoming,2006,Misdemeanor,0,3,18,16,19,56
Yates,2006,Felony,1,1,10,12,10,34
Yates,2006,Misdemeanor,0,3,3,14,22,42
Unknown,2006,Misdemeanor,0,0,0,0,0,0
Albany,2007,Felony,19,71,65,45,88,288
Albany,2007,Misdemeanor,0,64,61,296,310,731
Allegany,2007,Felony,6,11,5,7,14,43
Allegany,2007,Misdemeanor,0,9,11,14,25,59
Bronx,2007,Felony,317,488,29,70,204,1108
Bronx,2007,Misdemeanor,0,138,57,164,432,791
Broome,2007,Felony,63,49,76,69,95,352
Broome,2007,Misdemeanor,0,39,26,100,150,315
Cattaraugus,2007,Felony,1,11,38,23,24,97
Cattaraugus,2007,Misdemeanor,0,10,23,52,72,157
Cayuga,2007,Felony,1,12,1,11,5,30
Cayuga,2007,Misdemeanor,0,7,32,74,98,211
Chautauqua,2007,Felony,23,60,39,46,29,197
Chautauqua,2007,Misdemeanor,0,12,16,49,101,178
Chemung,2007,Felony,7,7,51,27,28,120
Chemung,2007,Misdemeanor,0,16,34,45,66,161
Chenango,2007,Felony,3,2,25,5,11,46
Chenango,2007,Misdemeanor,0,6,10,36,36,88
Clinton,2007,Felony,2,13,33,21,11,80
Clinton,2007,Misdemeanor,0,10,22,71,69,172
Columbia,2007,Felony,1,4,25,12,7,49
Columbia,2007,Misdemeanor,0,16,2,17,29,64
Cortland,2007,Felony,4,5,22,4,21,56
Cortland,2007,Misdemeanor,0,8,31,46,62,147
Delaware,2007,Felony,1,5,8,5,4,23
Delaware,2007,Misdemeanor,0,2,2,31,29,64
Dutchess,2007,Felony,4,49,56,56,59,224
Dutchess,2007,Misdemeanor,0,28,105,122,156,411
Erie,2007,Felony,135,162,257,127,133,814
Erie,2007,Misdemeanor,0,126,131,266,287,810
Essex,2007,Felony,0,12,7,4,10,33
Essex,2007,Misdemeanor,0,15,13,28,52,108
Franklin,2007,Felony,1,23,15,22,14,75
Franklin,2007,Misdemeanor,0,15,27,30,63,135
Fulton,2007,Felony,0,4,10,10,6,30
Fulton,2007,Misdemeanor,0,2,7,26,18,53
Genesee,2007,Felony,9,8,40,17,12,86
Genesee,2007,Misdemeanor,0,13,31,24,60,128
Greene,2007,Felony,4,3,16,11,6,40
Greene,2007,Misdemeanor,0,9,21,27,38,95
Hamilton,2007,Felony,1,3,0,0,0,4
Hamilton,2007,Misdemeanor,0,2,0,0,3,5
Herkimer,2007,Felony,19,4,20,25,13,81
Herkimer,2007,Misdemeanor,0,2,4,22,35,63
Jefferson,2007,Felony,18,19,18,31,35,121
Jefferson,2007,Misdemeanor,0,15,18,90,113,236
Kings,2007,Felony,357,200,51,93,255,956
Kings,2007,Misdemeanor,0,105,80,113,352,650
Lewis,2007,Felony,1,3,10,22,8,44
Lewis,2007,Misdemeanor,0,2,6,11,18,37
Livingston,2007,Felony,4,8,48,21,22,103
Livingston,2007,Misdemeanor,0,5,14,44,51,114
Madison,2007,Felony,4,0,17,3,1,25
Madison,2007,Misdemeanor,0,5,16,42,48,111
Monroe,2007,Felony,143,112,185,137,95,672
Monroe,2007,Misdemeanor,0,195,308,490,447,1440
Montgomery,2007,Felony,1,14,22,16,12,65
Montgomery,2007,Misdemeanor,0,7,7,21,24,59
Nassau,2007,Felony,151,178,174,130,190,823
Nassau,2007,Misdemeanor,0,129,1106,459,564,2258
New York,2007,Felony,259,661,27,213,285,1445
New York,2007,Misdemeanor,0,104,43,200,283,630
Niagara,2007,Felony,9,46,53,35,38,181
Niagara,2007,Misdemeanor,0,36,102,95,135,368
Oneida,2007,Felony,13,25,75,60,38,211
Oneida,2007,Misdemeanor,0,56,36,154,180,426
Onondaga,2007,Felony,89,81,42,142,109,463
Onondaga,2007,Misdemeanor,0,113,141,316,405,975
Ontario,2007,Felony,22,17,51,52,38,180
Ontario,2007,Misdemeanor,0,16,28,70,89,203
Orange,2007,Felony,53,96,146,92,70,457
Orange,2007,Misdemeanor,0,59,105,119,131,414
Orleans,2007,Felony,1,10,5,2,0,18
Orleans,2007,Misdemeanor,0,8,22,31,25,86
Oswego,2007,Felony,2,12,20,33,24,91
Oswego,2007,Misdemeanor,0,8,54,51,68,181
Otsego,2007,Felony,0,8,13,5,3,29
Otsego,2007,Misdemeanor,0,6,7,30,11,54
Putnam,2007,Felony,3,4,12,13,4,36
Putnam,2007,Misdemeanor,0,10,38,25,29,102
Queens,2007,Felony,372,175,63,136,258,1004
Queens,2007,Misdemeanor,0,71,61,260,374,766
Rensselaer,2007,Felony,17,30,26,21,32,126
Rensselaer,2007,Misdemeanor,0,32,31,103,220,386
Richmond,2007,Felony,37,34,6,30,62,169
Richmond,2007,Misdemeanor,0,66,66,97,96,325
Rockland,2007,Felony,17,89,70,38,34,248
Rockland,2007,Misdemeanor,0,31,37,67,56,191
St. Lawrence,2007,Felony,15,22,27,30,32,126
St. Lawrence,2007,Misdemeanor,0,16,28,65,77,186
Saratoga,2007,Felony,6,21,63,17,26,133
Saratoga,2007,Misdemeanor,0,24,49,91,84,248
Schenectady,2007,Felony,10,34,25,25,24,118
Schenectady,2007,Misdemeanor,0,23,21,126,117,287
Schoharie,2007,Felony,2,5,12,1,5,25
Schoharie,2007,Misdemeanor,0,5,2,6,3,16
Schuyler,2007,Felony,1,1,14,7,6,29
Schuyler,2007,Misdemeanor,0,1,8,13,8,30
Seneca,2007,Felony,5,1,24,11,6,47
Seneca,2007,Misdemeanor,0,3,7,14,17,41
Steuben,2007,Felony,13,16,46,38,45,158
Steuben,2007,Misdemeanor,0,8,17,33,89,147
Suffolk,2007,Felony,240,251,246,155,172,1064
Suffolk,2007,Misdemeanor,0,215,1620,514,704,3053
Sullivan,2007,Felony,10,26,48,65,28,177
Sullivan,2007,Misdemeanor,0,15,39,56,61,171
Tioga,2007,Felony,5,11,23,20,6,65
Tioga,2007,Misdemeanor,0,5,6,24,29,64
Tompkins,2007,Felony,7,12,24,16,23,82
Tompkins,2007,Misdemeanor,0,12,54,53,64,183
Ulster,2007,Felony,7,21,80,21,28,157
Ulster,2007,Misdemeanor,0,34,37,80,71,222
Warren,2007,Felony,2,5,38,24,26,95
Warren,2007,Misdemeanor,0,13,38,65,88,204
Washington,2007,Felony,6,5,17,11,22,61
Washington,2007,Misdemeanor,0,8,14,25,56,103
Wayne,2007,Felony,23,32,45,16,16,132
Wayne,2007,Misdemeanor,0,13,18,34,64,129
Westchester,2007,Felony,112,111,153,67,83,526
Westchester,2007,Misdemeanor,0,312,291,510,580,1693
Wyoming,2007,Felony,7,8,9,13,9,46
Wyoming,2007,Misdemeanor,0,12,17,17,38,84
Yates,2007,Felony,1,0,11,8,2,22
Yates,2007,Misdemeanor,0,2,6,10,16,34
Unknown,2007,Misdemeanor,0,0,0,0,0,0
Albany,2008,Felony,13,46,75,54,79,267
Albany,2008,Misdemeanor,0,68,73,279,235,655
Allegany,2008,Felony,7,14,6,11,19,57
Allegany,2008,Misdemeanor,0,3,14,23,59,99
Bronx,2008,Felony,316,443,33,97,171,1060
Bronx,2008,Misdemeanor,0,111,81,199,390,781
Broome,2008,Felony,37,54,56,57,57,261
Broome,2008,Misdemeanor,0,21,23,82,123,249
Cattaraugus,2008,Felony,3,7,42,29,16,97
Cattaraugus,2008,Misdemeanor,0,5,18,65,48,136
Cayuga,2008,Felony,4,16,3,22,12,57
Cayuga,2008,Misdemeanor,0,4,35,56,60,155
Chautauqua,2008,Felony,12,53,46,33,27,171
Chautauqua,2008,Misdemeanor,0,20,22,61,98,201
Chemung,2008,Felony,17,16,63,42,23,161
Chemung,2008,Misdemeanor,0,28,41,78,88,235
Chenango,2008,Felony,4,1,14,3,10,32
Chenango,2008,Misdemeanor,0,13,9,29,30,81
Clinton,2008,Felony,4,22,43,31,26,126
Clinton,2008,Misdemeanor,0,19,25,55,106,205
Columbia,2008,Felony,5,4,23,23,11,66
Columbia,2008,Misdemeanor,0,6,3,17,34,60
Cortland,2008,Felony,2,7,21,13,9,52
Cortland,2008,Misdemeanor,0,10,41,45,56,152
Delaware,2008,Felony,3,7,16,4,10,40
Delaware,2008,Misdemeanor,0,10,9,23,26,68
Dutchess,2008,Felony,6,44,69,46,61,226
Dutchess,2008,Misdemeanor,0,36,139,157,136,468
Erie,2008,Felony,154,164,273,112,128,831
Erie,2008,Misdemeanor,0,116,179,236,261,792
Essex,2008,Felony,0,2,18,9,11,40
Essex,2008,Misdemeanor,0,4,13,31,64,112
Franklin,2008,Felony,1,16,9,27,13,66
Franklin,2008,Misdemeanor,0,11,36,42,56,145
Fulton,2008,Felony,2,4,4,6,6,22
Fulton,2008,Misdemeanor,0,4,12,28,20,64
Genesee,2008,Felony,12,5,45,13,25,100
Genesee,2008,Misdemeanor,0,10,49,41,69,169
Greene,2008,Felony,2,3,18,4,8,35
Greene,2008,Misdemeanor,0,14,16,25,32,87
Hamilton,2008,Felony,0,0,0,1,0,1
Hamilton,2008,Misdemeanor,0,0,0,0,1,1
Herkimer,2008,Felony,12,7,26,26,23,94
Herkimer,2008,Misdemeanor,0,1,11,35,37,84
Jefferson,2008,Felony,8,27,25,39,27,126
Jefferson,2008,Misdemeanor,0,16,24,95,93,228
Kings,2008,Felony,294,193,56,84,261,888
Kings,2008,Misdemeanor,0,97,76,158,304,635
Lewis,2008,Felony,2,4,12,8,5,31
Lewis,2008,Misdemeanor,0,9,4,10,8,31
Livingston,2008,Felony,17,2,39,14,33,105
Livingston,2008,Misdemeanor,0,6,18,37,51,112
Madison,2008,Felony,2,1,15,4,3,25
Madison,2008,Misdemeanor,0,11,12,50,47,120
Monroe,2008,Felony,167,98,181,133,120,699
Monroe,2008,Misdemeanor,0,254,401,541,532,1728
Montgomery,2008,Felony,4,10,24,15,8,61
Montgomery,2008,Misdemeanor,0,7,2,16,14,39
Nassau,2008,Felony,144,154,195,95,193,781
Nassau,2008,Misdemeanor,0,116,1207,459,563,2345
New York,2008,Felony,236,621,43,221,209,1330
New York,2008,Misdemeanor,0,84,32,157,241,514
Niagara,2008,Felony,7,43,38,39,24,151
Niagara,2008,Misdemeanor,0,43,100,92,103,338
Oneida,2008,Felony,16,29,59,58,33,195
Oneida,2008,Misdemeanor,0,34,33,160,157,384
Onondaga,2008,Felony,111,73,64,86,123,457
Onondaga,2008,Misdemeanor,0,120,104,329,379,932
Ontario,2008,Felony,12,15,53,59,29,168
Ontario,2008,Misdemeanor,0,16,34,71,110,231
Orange,2008,Felony,49,58,105,73,52,337
Orange,2008,Misdemeanor,0,45,91,136,130,402
Orleans,2008,Felony,4,16,4,7,3,34
Orleans,2008,Misdemeanor,0,19,18,23,37,97
Oswego,2008,Felony,3,4,19,21,16,63
Oswego,2008,Misdemeanor,0,12,61,85,83,241
Otsego,2008,Felony,2,6,10,10,1,29
Otsego,2008,Misdemeanor,0,7,4,12,12,35
Putnam,2008,Felony,2,6,10,4,8,30
Putnam,2008,Misdemeanor,0,8,52,16,35,111
Queens,2008,Felony,234,128,54,122,237,775
Queens,2008,Misdemeanor,0,79,119,256,272,726
Rensselaer,2008,Felony,12,34,21,15,34,116
Rensselaer,2008,Misdemeanor,0,23,29,107,182,341
Richmond,2008,Felony,52,33,9,16,56,166
Richmond,2008,Misdemeanor,0,73,43,92,111,319
Rockland,2008,Felony,19,80,59,59,34,251
Rockland,2008,Misdemeanor,0,23,23,59,61,166
St. Lawrence,2008,Felony,14,23,27,24,27,115
St. Lawrence,2008,Misdemeanor,0,21,26,34,61,142
Saratoga,2008,Felony,6,15,69,23,34,147
Saratoga,2008,Misdemeanor,0,17,50,77,78,222
Schenectady,2008,Felony,10,31,22,26,26,115
Schenectady,2008,Misdemeanor,0,21,21,105,113,260
Schoharie,2008,Felony,0,1,16,5,7,29
Schoharie,2008,Misdemeanor,0,3,7,13,8,31
Schuyler,2008,Felony,0,2,22,7,3,34
Schuyler,2008,Misdemeanor,0,1,5,5,6,17
Seneca,2008,Felony,5,4,24,10,5,48
Seneca,2008,Misdemeanor,0,3,13,24,25,65
Steuben,2008,Felony,16,18,53,40,51,178
Steuben,2008,Misdemeanor,0,3,22,46,91,162
Suffolk,2008,Felony,166,245,261,156,186,1014
Suffolk,2008,Misdemeanor,0,199,1506,467,666,2838
Sullivan,2008,Felony,11,18,37,44,34,144
Sullivan,2008,Misdemeanor,0,14,40,39,49,142
Tioga,2008,Felony,11,3,21,18,10,63
Tioga,2008,Misdemeanor,0,4,4,14,27,49
Tompkins,2008,Felony,19,6,28,17,19,89
Tompkins,2008,Misdemeanor,0,17,41,34,56,148
Ulster,2008,Felony,17,20,48,18,30,133
Ulster,2008,Misdemeanor,0,48,43,93,95,279
Warren,2008,Felony,2,12,30,24,12,80
Warren,2008,Misdemeanor,0,22,45,60,92,219
Washington,2008,Felony,5,8,14,10,20,57
Washington,2008,Misdemeanor,0,7,18,32,64,121
Wayne,2008,Felony,16,19,61,18,9,123
Wayne,2008,Misdemeanor,0,13,20,52,68,153
Westchester,2008,Felony,90,127,111,75,92,495
Westchester,2008,Misdemeanor,0,293,286,491,610,1680
Wyoming,2008,Felony,1,12,4,5,7,29
Wyoming,2008,Misdemeanor,0,7,31,18,36,92
Yates,2008,Felony,7,4,10,8,8,37
Yates,2008,Misdemeanor,0,4,2,13,27,46
Unknown,2008,Misdemeanor,0,0,0,0,0,0
Albany,2009,Felony,22,57,88,59,71,297
Albany,2009,Misdemeanor,0,61,95,275,274,705
Allegany,2009,Felony,6,3,12,17,11,49
Allegany,2009,Misdemeanor,0,8,15,36,33,92
Bronx,2009,Felony,291,241,39,120,232,923
Bronx,2009,Misdemeanor,0,62,71,200,367,700
Broome,2009,Felony,64,63,48,70,74,319
Broome,2009,Misdemeanor,0,26,33,99,128,286
Cattaraugus,2009,Felony,2,15,39,41,17,114
Cattaraugus,2009,Misdemeanor,0,8,10,44,53,115
Cayuga,2009,Felony,9,25,5,31,26,96
Cayuga,2009,Misdemeanor,0,7,32,55,57,151
Chautauqua,2009,Felony,10,36,54,34,25,159
Chautauqua,2009,Misdemeanor,0,28,34,55,109,226
Chemung,2009,Felony,11,10,58,34,35,148
Chemung,2009,Misdemeanor,0,18,34,65,93,210
Chenango,2009,Felony,3,1,16,6,10,36
Chenango,2009,Misdemeanor,0,7,8,48,26,89
Clinton,2009,Felony,3,16,32,24,15,90
Clinton,2009,Misdemeanor,0,12,34,67,134,247
Columbia,2009,Felony,0,10,24,31,4,69
Columbia,2009,Misdemeanor,0,12,5,32,43,92
Cortland,2009,Felony,4,6,13,19,10,52
Cortland,2009,Misdemeanor,0,5,53,47,66,171
Delaware,2009,Felony,0,5,8,5,5,23
Delaware,2009,Misdemeanor,0,5,7,23,20,55
Dutchess,2009,Felony,4,36,64,59,44,207
Dutchess,2009,Misdemeanor,0,24,149,155,160,488
Erie,2009,Felony,209,180,311,165,141,1006
Erie,2009,Misdemeanor,0,124,213,287,303,927
Essex,2009,Felony,0,9,10,9,5,33
Essex,2009,Misdemeanor,0,4,16,22,33,75
Franklin,2009,Felony,1,14,6,20,8,49
Franklin,2009,Misdemeanor,0,13,38,33,63,147
Fulton,2009,Felony,0,3,7,10,4,24
Fulton,2009,Misdemeanor,0,4,15,24,38,81
Genesee,2009,Felony,17,12,39,21,27,116
Genesee,2009,Misdemeanor,0,7,46,48,60,161
Greene,2009,Felony,1,3,19,13,10,46
Greene,2009,Misdemeanor,0,10,31,42,40,123
Hamilton,2009,Felony,0,0,1,0,0,1
Hamilton,2009,Misdemeanor,0,0,2,0,0,2
Herkimer,2009,Felony,19,5,22,20,16,82
Herkimer,2009,Misdemeanor,0,5,7,19,23,54
Jefferson,2009,Felony,12,29,27,49,23,140
Jefferson,2009,Misdemeanor,0,19,27,91,134,271
Kings,2009,Felony,308,200,48,123,280,959
Kings,2009,Misdemeanor,0,104,79,173,322,678
Lewis,2009,Felony,1,4,4,4,6,19
Lewis,2009,Misdemeanor,0,4,10,13,15,42
Livingston,2009,Felony,7,11,42,15,37,112
Livingston,2009,Misdemeanor,0,18,10,25,47,100
Madison,2009,Felony,7,1,17,6,7,38
Madison,2009,Misdemeanor,0,4,18,54,29,105
Monroe,2009,Felony,161,87,211,122,130,711
Monroe,2009,Misdemeanor,0,187,432,509,501,1629
Montgomery,2009,Felony,3,5,27,18,9,62
Montgomery,2009,Misdemeanor,0,8,1,24,13,46
Nassau,2009,Felony,159,163,180,144,153,799
Nassau,2009,Misdemeanor,0,161,1235,479,593,2468
New York,2009,Felony,258,564,25,256,239,1342
New York,2009,Misdemeanor,0,73,29,161,257,520
Niagara,2009,Felony,13,44,30,34,29,150
Niagara,2009,Misdemeanor,0,29,115,104,137,385
Oneida,2009,Felony,23,21,81,53,56,234
Oneida,2009,Misdemeanor,0,25,41,134,186,386
Onondaga,2009,Felony,91,81,42,71,98,383
Onondaga,2009,Misdemeanor,0,105,145,355,355,960
Ontario,2009,Felony,18,43,69,50,27,207
Ontario,2009,Misdemeanor,0,32,36,69,107,244
Orange,2009,Felony,43,60,128,99,57,387
Orange,2009,Misdemeanor,0,40,74,109,118,341
Orleans,2009,Felony,2,8,4,5,1,20
Orleans,2009,Misdemeanor,0,6,11,31,39,87
Oswego,2009,Felony,5,5,11,19,29,69
Oswego,2009,Misdemeanor,0,23,50,77,75,225
Otsego,2009,Felony,2,9,17,11,6,45
Otsego,2009,Misdemeanor,0,5,4,23,10,42
Putnam,2009,Felony,0,7,11,6,5,29
Putnam,2009,Misdemeanor,0,6,46,23,17,92
Queens,2009,Felony,232,96,45,109,207,689
Queens,2009,Misdemeanor,0,66,105,221,265,657
Rensselaer,2009,Felony,5,17,18,12,18,70
Rensselaer,2009,Misdemeanor,0,31,29,105,173,338
Richmond,2009,Felony,43,32,3,34,43,155
Richmond,2009,Misdemeanor,0,64,36,120,120,340
Rockland,2009,Felony,13,55,55,65,45,233
Rockland,2009,Misdemeanor,0,22,25,55,60,162
St. Lawrence,2009,Felony,17,25,32,26,29,129
St. Lawrence,2009,Misdemeanor,0,13,15,29,50,107
Saratoga,2009,Felony,10,22,80,28,22,162
Saratoga,2009,Misdemeanor,0,27,34,70,80,211
Schenectady,2009,Felony,18,23,32,13,26,112
Schenectady,2009,Misdemeanor,0,14,16,75,93,198
Schoharie,2009,Felony,2,1,15,7,3,28
Schoharie,2009,Misdemeanor,0,4,7,16,7,34
Schuyler,2009,Felony,0,6,13,7,3,29
Schuyler,2009,Misdemeanor,0,2,7,7,10,26
Seneca,2009,Felony,3,2,19,9,8,41
Seneca,2009,Misdemeanor,0,5,7,19,24,55
Steuben,2009,Felony,8,15,50,21,35,129
Steuben,2009,Misdemeanor,0,6,27,48,82,163
Suffolk,2009,Felony,201,180,209,143,160,893
Suffolk,2009,Misdemeanor,0,196,1425,513,653,2787
Sullivan,2009,Felony,6,10,51,37,28,132
Sullivan,2009,Misdemeanor,0,12,31,49,48,140
Tioga,2009,Felony,8,7,17,21,8,61
Tioga,2009,Misdemeanor,0,6,4,16,32,58
Tompkins,2009,Felony,13,10,39,14,27,103
Tompkins,2009,Misdemeanor,0,5,43,31,69,148
Ulster,2009,Felony,11,26,58,46,31,172
Ulster,2009,Misdemeanor,0,41,38,101,115,295
Warren,2009,Felony,0,8,27,15,14,64
Warren,2009,Misdemeanor,0,15,37,106,92,250
Washington,2009,Felony,1,0,12,19,14,46
Washington,2009,Misdemeanor,0,13,22,46,73,154
Wayne,2009,Felony,21,24,65,19,13,142
Wayne,2009,Misdemeanor,0,7,16,47,65,135
Westchester,2009,Felony,82,83,132,49,100,446
Westchester,2009,Misdemeanor,0,342,296,524,605,1767
Wyoming,2009,Felony,2,10,6,11,10,39
Wyoming,2009,Misdemeanor,0,4,19,16,33,72
Yates,2009,Felony,8,0,13,12,8,41
Yates,2009,Misdemeanor,0,3,3,10,29,45
Unknown,2009,Misdemeanor,0,0,0,0,0,0
Albany,2010,Felony,15,74,105,40,89,323
Albany,2010,Misdemeanor,0,80,109,293,301,783
Allegany,2010,Felony,4,10,12,11,11,48
Allegany,2010,Misdemeanor,0,8,21,36,43,108
Bronx,2010,Felony,268,178,38,94,192,770
Bronx,2010,Misdemeanor,0,61,50,145,281,537
Broome,2010,Felony,51,51,84,52,64,302
Broome,2010,Misdemeanor,0,32,29,103,149,313
Cattaraugus,2010,Felony,0,15,37,21,7,80
Cattaraugus,2010,Misdemeanor,0,5,13,27,42,87
Cayuga,2010,Felony,3,17,13,22,20,75
Cayuga,2010,Misdemeanor,0,8,48,75,55,186
Chautauqua,2010,Felony,8,31,37,36,17,129
Chautauqua,2010,Misdemeanor,0,21,32,63,129,245
Chemung,2010,Felony,6,19,52,22,16,115
Chemung,2010,Misdemeanor,0,16,31,54,65,166
Chenango,2010,Felony,4,10,11,14,11,50
Chenango,2010,Misdemeanor,0,11,9,26,38,84
Clinton,2010,Felony,5,19,35,14,15,88
Clinton,2010,Misdemeanor,0,12,44,56,79,191
Columbia,2010,Felony,4,2,20,17,11,54
Columbia,2010,Misdemeanor,0,9,11,30,45,95
Cortland,2010,Felony,2,11,12,22,12,59
Cortland,2010,Misdemeanor,0,6,26,40,53,125
Delaware,2010,Felony,0,11,8,7,6,32
Delaware,2010,Misdemeanor,0,8,5,8,14,35
Dutchess,2010,Felony,5,34,55,57,44,195
Dutchess,2010,Misdemeanor,0,61,160,181,178,580
Erie,2010,Felony,183,119,318,135,128,883
Erie,2010,Misdemeanor,0,95,223,285,288,891
Essex,2010,Felony,0,14,16,3,1,34
Essex,2010,Misdemeanor,0,6,14,28,26,74
Franklin,2010,Felony,2,16,8,12,9,47
Franklin,2010,Misdemeanor,0,15,30,25,32,102
Fulton,2010,Felony,2,9,3,13,10,37
Fulton,2010,Misdemeanor,0,4,8,28,24,64
Genesee,2010,Felony,9,7,38,11,25,90
Genesee,2010,Misdemeanor,0,5,46,40,58,149
Greene,2010,Felony,3,11,18,10,14,56
Greene,2010,Misdemeanor,0,7,24,34,47,112
Hamilton,2010,Felony,0,0,2,0,0,2
Hamilton,2010,Misdemeanor,0,1,0,1,1,3
Herkimer,2010,Felony,8,6,13,18,10,55
Herkimer,2010,Misdemeanor,0,2,4,14,24,44
Jefferson,2010,Felony,11,35,45,54,51,196
Jefferson,2010,Misdemeanor,0,21,25,151,145,342
Kings,2010,Felony,227,118,53,93,221,712
Kings,2010,Misdemeanor,0,110,87,140,290,627
Lewis,2010,Felony,3,5,5,3,5,21
Lewis,2010,Misdemeanor,0,1,14,9,17,41
Livingston,2010,Felony,4,14,38,13,30,99
Livingston,2010,Misdemeanor,0,13,20,28,39,100
Madison,2010,Felony,6,2,16,25,6,55
Madison,2010,Misdemeanor,0,6,9,19,39,73
Monroe,2010,Felony,179,46,173,85,112,595
Monroe,2010,Misdemeanor,0,189,366,540,452,1547
Montgomery,2010,Felony,1,5,20,14,10,50
Montgomery,2010,Misdemeanor,0,10,2,18,15,45
Nassau,2010,Felony,147,72,168,96,155,638
Nassau,2010,Misdemeanor,0,113,1441,380,610,2544
New York,2010,Felony,256,516,37,260,241,1310
New York,2010,Misdemeanor,0,78,39,133,222,472
Niagara,2010,Felony,13,27,26,33,18,117
Niagara,2010,Misdemeanor,0,27,115,83,95,320
Oneida,2010,Felony,15,26,65,44,64,214
Oneida,2010,Misdemeanor,0,31,39,118,173,361
Onondaga,2010,Felony,76,61,70,90,114,411
Onondaga,2010,Misdemeanor,0,100,143,348,429,1020
Ontario,2010,Felony,21,32,52,54,51,210
Ontario,2010,Misdemeanor,0,28,24,67,114,233
Orange,2010,Felony,38,53,91,81,69,332
Orange,2010,Misdemeanor,0,40,64,105,118,327
Orleans,2010,Felony,1,5,3,5,5,19
Orleans,2010,Misdemeanor,0,5,23,25,31,84
Oswego,2010,Felony,6,8,12,6,9,41
Oswego,2010,Misdemeanor,0,18,91,67,91,267
Otsego,2010,Felony,1,6,13,6,7,33
Otsego,2010,Misdemeanor,0,9,9,17,19,54
Putnam,2010,Felony,7,1,20,10,7,45
Putnam,2010,Misdemeanor,0,10,48,20,12,90
Queens,2010,Felony,216,64,44,117,203,644
Queens,2010,Misdemeanor,0,71,162,202,260,695
Rensselaer,2010,Felony,5,17,31,16,22,91
Rensselaer,2010,Misdemeanor,0,19,29,109,132,289
Richmond,2010,Felony,48,29,5,28,54,164
Richmond,2010,Misdemeanor,0,55,34,77,120,286
Rockland,2010,Felony,12,29,48,56,39,184
Rockland,2010,Misdemeanor,0,26,35,62,48,171
St. Lawrence,2010,Felony,7,18,23,15,15,78
St. Lawrence,2010,Misdemeanor,0,7,24,31,50,112
Saratoga,2010,Felony,8,13,85,30,33,169
Saratoga,2010,Misdemeanor,0,14,39,65,92,210
Schenectady,2010,Felony,13,29,34,24,19,119
Schenectady,2010,Misdemeanor,0,14,30,99,88,231
Schoharie,2010,Felony,0,4,15,3,6,28
Schoharie,2010,Misdemeanor,0,4,6,23,16,49
Schuyler,2010,Felony,1,5,8,3,3,20
Schuyler,2010,Misdemeanor,0,1,6,2,14,23
Seneca,2010,Felony,0,5,24,10,6,45
Seneca,2010,Misdemeanor,0,0,3,17,33,53
Steuben,2010,Felony,14,16,36,44,33,143
Steuben,2010,Misdemeanor,0,6,23,38,72,139
Suffolk,2010,Felony,168,113,247,124,181,833
Suffolk,2010,Misdemeanor,0,189,1405,576,771,2941
Sullivan,2010,Felony,11,7,41,27,14,100
Sullivan,2010,Misdemeanor,0,8,49,37,34,128
Tioga,2010,Felony,12,6,31,24,14,87
Tioga,2010,Misdemeanor,0,5,6,19,22,52
Tompkins,2010,Felony,16,0,26,21,20,83
Tompkins,2010,Misdemeanor,0,8,39,38,47,132
Ulster,2010,Felony,8,14,54,20,14,110
Ulster,2010,Misdemeanor,0,34,38,118,104,294
Warren,2010,Felony,3,14,22,24,21,84
Warren,2010,Misdemeanor,0,15,39,74,79,207
Washington,2010,Felony,6,0,26,15,12,59
Washington,2010,Misdemeanor,0,6,25,34,65,130
Wayne,2010,Felony,20,20,39,17,18,114
Wayne,2010,Misdemeanor,0,11,14,35,62,122
Westchester,2010,Felony,103,65,140,51,75,434
Westchester,2010,Misdemeanor,0,277,353,466,538,1634
Wyoming,2010,Felony,1,14,16,6,2,39
Wyoming,2010,Misdemeanor,0,5,23,13,26,67
Yates,2010,Felony,4,4,14,10,4,36
Yates,2010,Misdemeanor,0,2,6,13,21,42
Unknown,2010,Misdemeanor,0,0,0,0,0,0
Albany,2011,Felony,11,46,114,70,108,349
Albany,2011,Misdemeanor,0,69,87,224,266,646
Allegany,2011,Felony,4,12,5,6,3,30
Allegany,2011,Misdemeanor,0,9,20,25,50,104
Bronx,2011,Felony,308,157,27,98,148,738
Bronx,2011,Misdemeanor,0,62,79,160,325,626
Broome,2011,Felony,52,29,69,57,55,262
Broome,2011,Misdemeanor,0,28,43,134,169,374
Cattaraugus,2011,Felony,2,17,52,24,10,105
Cattaraugus,2011,Misdemeanor,0,6,34,48,55,143
Cayuga,2011,Felony,5,21,11,27,18,82
Cayuga,2011,Misdemeanor,0,4,36,54,70,164
Chautauqua,2011,Felony,7,17,31,33,15,103
Chautauqua,2011,Misdemeanor,0,16,41,67,133,257
Chemung,2011,Felony,13,8,40,21,26,108
Chemung,2011,Misdemeanor,0,17,41,56,62,176
Chenango,2011,Felony,4,1,11,16,13,45
Chenango,2011,Misdemeanor,0,10,15,27,31,83
Clinton,2011,Felony,4,18,30,25,14,91
Clinton,2011,Misdemeanor,0,17,31,49,95,192
Columbia,2011,Felony,0,0,23,17,6,46
Columbia,2011,Misdemeanor,0,8,5,21,21,55
Cortland,2011,Felony,5,14,10,15,10,54
Cortland,2011,Misdemeanor,0,12,36,40,49,137
Delaware,2011,Felony,7,10,8,7,2,34
Delaware,2011,Misdemeanor,0,3,8,14,18,43
Dutchess,2011,Felony,4,24,60,63,53,204
Dutchess,2011,Misdemeanor,0,44,138,194,163,539
Erie,2011,Felony,132,129,343,85,124,813
Erie,2011,Misdemeanor,0,87,157,238,267,749
Essex,2011,Felony,2,13,13,10,4,42
Essex,2011,Misdemeanor,0,6,10,23,34,73
Franklin,2011,Felony,7,14,14,12,10,57
Franklin,2011,Misdemeanor,0,7,29,23,54,113
Fulton,2011,Felony,1,2,10,11,5,29
Fulton,2011,Misdemeanor,0,6,14,24,24,68
Genesee,2011,Felony,3,7,42,17,23,92
Genesee,2011,Misdemeanor,0,13,51,41,61,166
Greene,2011,Felony,11,8,19,15,11,64
Greene,2011,Misdemeanor,0,15,25,43,44,127
Hamilton,2011,Felony,0,0,2,1,0,3
Hamilton,2011,Misdemeanor,0,0,2,3,3,8
Herkimer,2011,Felony,6,7,19,23,13,68
Herkimer,2011,Misdemeanor,0,6,17,23,29,75
Jefferson,2011,Felony,16,56,23,44,25,164
Jefferson,2011,Misdemeanor,0,18,29,127,102,276
Kings,2011,Felony,202,80,53,74,168,577
Kings,2011,Misdemeanor,0,69,79,99,240,487
Lewis,2011,Felony,4,0,13,9,1,27
Lewis,2011,Misdemeanor,0,1,16,13,12,42
Livingston,2011,Felony,6,7,42,16,23,94
Livingston,2011,Misdemeanor,0,11,20,36,25,92
Madison,2011,Felony,7,3,16,6,5,37
Madison,2011,Misdemeanor,0,7,17,20,40,84
Monroe,2011,Felony,151,75,199,66,106,597
Monroe,2011,Misdemeanor,0,153,369,445,481,1448
Montgomery,2011,Felony,4,8,33,20,13,78
Montgomery,2011,Misdemeanor,0,4,3,17,27,51
Nassau,2011,Felony,119,49,191,74,147,580
Nassau,2011,Misdemeanor,0,81,1079,380,559,2099
New York,2011,Felony,232,493,39,231,298,1293
New York,2011,Misdemeanor,0,97,52,154,265,568
Niagara,2011,Felony,11,23,14,27,20,95
Niagara,2011,Misdemeanor,0,30,120,86,75,311
Oneida,2011,Felony,25,37,82,37,42,223
Oneida,2011,Misdemeanor,0,26,37,126,133,322
Onondaga,2011,Felony,79,76,46,117,100,418
Onondaga,2011,Misdemeanor,0,100,153,413,423,1089
Ontario,2011,Felony,12,20,57,47,31,167
Ontario,2011,Misdemeanor,0,16,33,64,90,203
Orange,2011,Felony,46,41,152,70,43,352
Orange,2011,Misdemeanor,0,36,93,149,105,383
Orleans,2011,Felony,0,12,2,6,5,25
Orleans,2011,Misdemeanor,0,7,15,11,11,44
Oswego,2011,Felony,3,6,26,31,10,76
Oswego,2011,Misdemeanor,0,24,80,93,99,296
Otsego,2011,Felony,0,2,14,9,1,26
Otsego,2011,Misdemeanor,0,3,7,26,18,54
Putnam,2011,Felony,4,3,20,8,7,42
Putnam,2011,Misdemeanor,0,9,33,24,26,92
Queens,2011,Felony,256,64,67,108,178,673
Queens,2011,Misdemeanor,0,59,145,250,230,684
Rensselaer,2011,Felony,10,14,34,9,26,93
Rensselaer,2011,Misdemeanor,0,22,27,105,112,266
Richmond,2011,Felony,38,31,3,22,42,136
Richmond,2011,Misdemeanor,0,32,28,48,70,178
Rockland,2011,Felony,14,38,41,48,47,188
Rockland,2011,Misdemeanor,0,33,42,47,70,192
St. Lawrence,2011,Felony,12,32,32,20,26,122
St. Lawrence,2011,Misdemeanor,0,12,24,47,46,129
Saratoga,2011,Felony,10,15,75,18,22,140
Saratoga,2011,Misdemeanor,0,18,33,75,70,196
Schenectady,2011,Felony,16,16,34,18,16,100
Schenectady,2011,Misdemeanor,0,20,28,102,90,240
Schoharie,2011,Felony,5,5,14,5,4,33
Schoharie,2011,Misdemeanor,0,2,6,12,18,38
Schuyler,2011,Felony,1,2,7,11,9,30
Schuyler,2011,Misdemeanor,0,1,5,3,11,20
Seneca,2011,Felony,0,3,25,8,2,38
Seneca,2011,Misdemeanor,0,7,10,24,33,74
Steuben,2011,Felony,19,14,34,29,22,118
Steuben,2011,Misdemeanor,0,8,26,30,75,139
Suffolk,2011,Felony,176,120,310,164,151,921
Suffolk,2011,Misdemeanor,0,210,1188,595,639,2632
Sullivan,2011,Felony,7,9,40,24,13,93
Sullivan,2011,Misdemeanor,0,16,47,44,44,151
Tioga,2011,Felony,4,7,12,17,13,53
Tioga,2011,Misdemeanor,0,6,7,11,27,51
Tompkins,2011,Felony,6,3,35,17,22,83
Tompkins,2011,Misdemeanor,0,1,41,36,42,120
Ulster,2011,Felony,6,12,81,22,24,145
Ulster,2011,Misdemeanor,0,23,29,102,81,235
Warren,2011,Felony,4,16,18,20,21,79
Warren,2011,Misdemeanor,0,25,39,74,109,247
Washington,2011,Felony,2,3,24,16,19,64
Washington,2011,Misdemeanor,0,12,27,27,58,124
Wayne,2011,Felony,18,12,63,16,10,119
Wayne,2011,Misdemeanor,0,12,17,55,55,139
Westchester,2011,Felony,114,74,140,60,111,499
Westchester,2011,Misdemeanor,0,260,315,404,510,1489
Wyoming,2011,Felony,1,12,10,13,12,48
Wyoming,2011,Misdemeanor,0,9,23,17,39,88
Yates,2011,Felony,3,3,16,9,7,38
Yates,2011,Misdemeanor,0,0,2,7,30,39
Unknown,2011,Misdemeanor,0,0,0,0,0,0
Albany,2012,Felony,6,68,90,69,76,309
Albany,2012,Misdemeanor,0,56,92,219,255,622
Allegany,2012,Felony,4,14,2,9,5,34
Allegany,2012,Misdemeanor,0,13,22,25,37,97
Bronx,2012,Felony,277,105,28,83,139,632
Bronx,2012,Misdemeanor,0,51,82,169,273,575
Broome,2012,Felony,51,40,82,87,76,336
Broome,2012,Misdemeanor,0,57,41,139,144,381
Cattaraugus,2012,Felony,0,27,43,17,17,104
Cattaraugus,2012,Misdemeanor,0,6,23,49,43,121
Cayuga,2012,Felony,2,16,18,34,13,83
Cayuga,2012,Misdemeanor,0,9,40,56,70,175
Chautauqua,2012,Felony,11,15,26,39,22,113
Chautauqua,2012,Misdemeanor,0,14,55,56,125,250
Chemung,2012,Felony,7,18,54,29,10,118
Chemung,2012,Misdemeanor,0,20,40,59,63,182
Chenango,2012,Felony,10,5,21,16,11,63
Chenango,2012,Misdemeanor,0,12,21,32,22,87
Clinton,2012,Felony,5,25,35,24,27,116
Clinton,2012,Misdemeanor,0,22,26,63,63,174
Columbia,2012,Felony,1,2,20,5,5,33
Columbia,2012,Misdemeanor,0,6,3,30,34,73
Cortland,2012,Felony,4,11,9,16,17,57
Cortland,2012,Misdemeanor,0,8,41,56,55,160
Delaware,2012,Felony,1,3,12,4,4,24
Delaware,2012,Misdemeanor,0,6,5,18,17,46
Dutchess,2012,Felony,6,39,45,27,38,155
Dutchess,2012,Misdemeanor,0,74,132,183,189,578
Erie,2012,Felony,121,102,246,96,111,676
Erie,2012,Misdemeanor,0,109,110,227,246,692
Essex,2012,Felony,3,13,7,14,2,39
Essex,2012,Misdemeanor,0,2,8,21,33,64
Franklin,2012,Felony,8,22,12,32,10,84
Franklin,2012,Misdemeanor,0,3,41,23,44,111
Fulton,2012,Felony,1,5,6,7,7,26
Fulton,2012,Misdemeanor,0,3,16,25,38,82
Genesee,2012,Felony,5,6,31,16,21,79
Genesee,2012,Misdemeanor,0,11,43,41,48,143
Greene,2012,Felony,5,6,18,16,11,56
Greene,2012,Misdemeanor,0,7,25,50,41,123
Hamilton,2012,Felony,0,0,0,1,2,3
Hamilton,2012,Misdemeanor,0,1,1,3,4,9
Herkimer,2012,Felony,3,4,14,17,10,48
Herkimer,2012,Misdemeanor,0,8,7,21,24,60
Jefferson,2012,Felony,13,38,28,56,36,171
Jefferson,2012,Misdemeanor,0,12,27,116,108,263
Kings,2012,Felony,174,65,49,74,170,532
Kings,2012,Misdemeanor,0,57,38,99,223,417
Lewis,2012,Felony,3,3,2,12,5,25
Lewis,2012,Misdemeanor,0,1,11,17,16,45
Livingston,2012,Felony,4,7,40,24,21,96
Livingston,2012,Misdemeanor,0,10,15,39,41,105
Madison,2012,Felony,5,4,18,8,8,43
Madison,2012,Misdemeanor,0,7,10,29,34,80
Monroe,2012,Felony,149,37,182,85,93,546
Monroe,2012,Misdemeanor,0,178,395,413,458,1444
Montgomery,2012,Felony,5,14,32,18,11,80
Montgomery,2012,Misdemeanor,0,8,2,17,18,45
Nassau,2012,Felony,90,44,188,76,112,510
Nassau,2012,Misdemeanor,0,89,1043,276,438,1846
New York,2012,Felony,220,483,37,251,229,1220
New York,2012,Misdemeanor,0,69,27,150,320,566
Niagara,2012,Felony,13,22,27,19,23,104
Niagara,2012,Misdemeanor,0,31,98,79,78,286
Oneida,2012,Felony,20,29,55,43,41,188
Oneida,2012,Misdemeanor,0,24,43,125,151,343
Onondaga,2012,Felony,88,92,55,89,101,425
Onondaga,2012,Misdemeanor,0,107,155,446,464,1172
Ontario,2012,Felony,17,16,53,60,29,175
Ontario,2012,Misdemeanor,0,8,34,79,99,220
Orange,2012,Felony,34,33,85,73,51,276
Orange,2012,Misdemeanor,0,44,92,106,105,347
Orleans,2012,Felony,3,7,1,5,6,22
Orleans,2012,Misdemeanor,0,11,15,25,26,77
Oswego,2012,Felony,1,15,20,41,21,98
Oswego,2012,Misdemeanor,0,30,60,113,108,311
Otsego,2012,Felony,1,6,13,4,3,27
Otsego,2012,Misdemeanor,0,9,12,13,12,46
Putnam,2012,Felony,6,9,14,5,4,38
Putnam,2012,Misdemeanor,0,24,38,30,21,113
Queens,2012,Felony,189,79,63,110,147,588
Queens,2012,Misdemeanor,0,55,155,206,185,601
Rensselaer,2012,Felony,12,8,26,9,20,75
Rensselaer,2012,Misdemeanor,0,17,26,113,97,253
Richmond,2012,Felony,54,31,4,26,44,159
Richmond,2012,Misdemeanor,0,17,31,61,74,183
Rockland,2012,Felony,9,46,37,65,36,193
Rockland,2012,Misdemeanor,0,47,41,62,69,219
St. Lawrence,2012,Felony,11,50,36,26,28,151
St. Lawrence,2012,Misdemeanor,0,8,20,36,45,109
Saratoga,2012,Felony,5,13,57,25,23,123
Saratoga,2012,Misdemeanor,0,16,38,94,82,230
Schenectady,2012,Felony,21,31,36,25,38,151
Schenectady,2012,Misdemeanor,0,12,15,108,105,240
Schoharie,2012,Felony,1,6,8,6,4,25
Schoharie,2012,Misdemeanor,0,9,9,17,10,45
Schuyler,2012,Felony,0,1,8,8,6,23
Schuyler,2012,Misdemeanor,0,1,4,10,6,21
Seneca,2012,Felony,1,7,18,13,6,45
Seneca,2012,Misdemeanor,0,10,8,16,14,48
Steuben,2012,Felony,15,11,33,31,43,133
Steuben,2012,Misdemeanor,0,9,30,29,57,125
Suffolk,2012,Felony,180,109,272,180,154,895
Suffolk,2012,Misdemeanor,0,191,1262,570,658,2681
Sullivan,2012,Felony,7,12,42,27,24,112
Sullivan,2012,Misdemeanor,0,10,35,29,53,127
Tioga,2012,Felony,8,9,23,12,9,61
Tioga,2012,Misdemeanor,0,2,3,16,20,41
Tompkins,2012,Felony,12,3,33,11,11,70
Tompkins,2012,Misdemeanor,0,12,39,59,46,156
Ulster,2012,Felony,3,14,36,16,26,95
Ulster,2012,Misdemeanor,0,33,37,109,102,281
Warren,2012,Felony,3,13,24,36,24,100
Warren,2012,Misdemeanor,0,14,43,59,84,200
Washington,2012,Felony,1,1,6,9,11,28
Washington,2012,Misdemeanor,0,6,17,55,42,120
Wayne,2012,Felony,21,14,59,17,10,121
Wayne,2012,Misdemeanor,0,5,24,36,62,127
Westchester,2012,Felony,154,66,142,66,128,556
Westchester,2012,Misdemeanor,0,304,270,478,525,1577
Wyoming,2012,Felony,4,14,10,9,6,43
Wyoming,2012,Misdemeanor,0,8,31,16,31,86
Yates,2012,Felony,5,4,9,5,4,27
Yates,2012,Misdemeanor,0,8,4,9,26,47
Unknown,2012,Misdemeanor,0,0,0,0,0,0
Albany,2013,Felony,26,72,95,90,101,384
Albany,2013,Misdemeanor,0,45,112,248,238,643
Allegany,2013,Felony,2,6,4,13,13,38
Allegany,2013,Misdemeanor,0,15,8,17,25,65
Bronx,2013,Felony,292,119,35,75,156,677
Bronx,2013,Misdemeanor,0,44,80,181,344,649
Broome,2013,Felony,64,26,53,92,89,324
Broome,2013,Misdemeanor,0,49,44,165,203,461
Cattaraugus,2013,Felony,4,7,48,28,24,111
Cattaraugus,2013,Misdemeanor,0,8,23,65,42,138
Cayuga,2013,Felony,5,18,18,25,20,86
Cayuga,2013,Misdemeanor,0,13,38,55,85,191
Chautauqua,2013,Felony,10,41,33,45,23,152
Chautauqua,2013,Misdemeanor,0,19,52,108,197,376
Chemung,2013,Felony,16,13,36,37,11,113
Chemung,2013,Misdemeanor,0,11,23,34,54,122
Chenango,2013,Felony,10,4,7,12,17,50
Chenango,2013,Misdemeanor,0,15,19,27,23,84
Clinton,2013,Felony,8,36,32,20,27,123
Clinton,2013,Misdemeanor,0,10,23,44,75,152
Columbia,2013,Felony,0,1,11,4,4,20
Columbia,2013,Misdemeanor,0,6,1,15,11,33
Cortland,2013,Felony,6,21,16,16,23,82
Cortland,2013,Misdemeanor,0,14,41,66,46,167
Delaware,2013,Felony,1,18,7,11,7,44
Delaware,2013,Misdemeanor,0,7,6,17,21,51
Dutchess,2013,Felony,3,28,24,52,45,152
Dutchess,2013,Misdemeanor,0,51,101,159,189,500
Erie,2013,Felony,86,78,265,78,89,596
Erie,2013,Misdemeanor,0,86,112,199,266,663
Essex,2013,Felony,0,7,6,7,6,26
Essex,2013,Misdemeanor,0,4,11,25,29,69
Franklin,2013,Felony,3,25,10,22,17,77
Franklin,2013,Misdemeanor,0,9,17,26,57,109
Fulton,2013,Felony,1,3,5,9,9,27
Fulton,2013,Misdemeanor,0,4,10,20,39,73
Genesee,2013,Felony,8,7,24,19,20,78
Genesee,2013,Misdemeanor,0,8,43,45,66,162
Greene,2013,Felony,3,14,9,10,11,47
Greene,2013,Misdemeanor,0,9,19,36,39,103
Hamilton,2013,Felony,0,2,4,2,2,10
Hamilton,2013,Misdemeanor,0,0,1,2,3,6
Herkimer,2013,Felony,7,5,15,22,9,58
Herkimer,2013,Misdemeanor,0,5,9,27,34,75
Jefferson,2013,Felony,17,53,17,49,28,164
Jefferson,2013,Misdemeanor,0,13,29,113,107,262
Kings,2013,Felony,178,77,53,66,160,534
Kings,2013,Misdemeanor,0,63,46,121,265,495
Lewis,2013,Felony,0,1,5,3,2,11
Lewis,2013,Misdemeanor,0,4,10,12,7,33
Livingston,2013,Felony,3,9,32,13,19,76
Livingston,2013,Misdemeanor,0,25,11,20,38,94
Madison,2013,Felony,7,1,14,5,8,35
Madison,2013,Misdemeanor,0,8,13,42,32,95
Monroe,2013,Felony,142,36,172,61,100,511
Monroe,2013,Misdemeanor,0,137,412,416,449,1414
Montgomery,2013,Felony,4,12,20,18,9,63
Montgomery,2013,Misdemeanor,0,4,3,25,24,56
Nassau,2013,Felony,104,56,197,49,119,525
Nassau,2013,Misdemeanor,0,117,874,265,443,1699
New York,2013,Felony,173,423,40,205,248,1089
New York,2013,Misdemeanor,0,93,25,130,282,530
Niagara,2013,Felony,3,21,16,19,15,74
Niagara,2013,Misdemeanor,0,22,102,71,76,271
Oneida,2013,Felony,16,11,72,38,38,175
Oneida,2013,Misdemeanor,0,30,44,137,184,395
Onondaga,2013,Felony,64,88,50,114,108,424
Onondaga,2013,Misdemeanor,0,153,203,409,377,1142
Ontario,2013,Felony,18,16,61,56,53,204
Ontario,2013,Misdemeanor,0,13,47,90,92,242
Orange,2013,Felony,39,48,82,77,40,286
Orange,2013,Misdemeanor,0,40,85,150,130,405
Orleans,2013,Felony,3,7,2,6,2,20
Orleans,2013,Misdemeanor,0,6,18,21,24,69
Oswego,2013,Felony,2,14,12,29,15,72
Oswego,2013,Misdemeanor,0,42,58,91,102,293
Otsego,2013,Felony,0,6,6,4,6,22
Otsego,2013,Misdemeanor,0,7,4,15,18,44
Putnam,2013,Felony,1,8,21,6,7,43
Putnam,2013,Misdemeanor,0,26,34,26,26,112
Queens,2013,Felony,224,66,59,120,147,616
Queens,2013,Misdemeanor,0,31,132,159,201,523
Rensselaer,2013,Felony,8,18,15,22,19,82
Rensselaer,2013,Misdemeanor,0,28,29,103,114,274
Richmond,2013,Felony,30,30,8,33,43,144
Richmond,2013,Misdemeanor,0,25,42,60,74,201
Rockland,2013,Felony,22,32,41,65,47,207
Rockland,2013,Misdemeanor,0,55,41,68,38,202
St. Lawrence,2013,Felony,11,32,40,28,33,144
St. Lawrence,2013,Misdemeanor,0,16,23,34,52,125
Saratoga,2013,Felony,2,13,64,36,34,149
Saratoga,2013,Misdemeanor,0,14,49,99,65,227
Schenectady,2013,Felony,12,30,37,42,27,148
Schenectady,2013,Misdemeanor,0,8,15,112,94,229
Schoharie,2013,Felony,4,9,7,9,4,33
Schoharie,2013,Misdemeanor,0,8,12,24,18,62
Schuyler,2013,Felony,0,1,10,11,3,25
Schuyler,2013,Misdemeanor,0,2,6,5,6,19
Seneca,2013,Felony,1,15,17,8,15,56
Seneca,2013,Misdemeanor,0,3,9,26,34,72
Steuben,2013,Felony,15,13,32,58,41,159
Steuben,2013,Misdemeanor,0,22,16,49,62,149
Suffolk,2013,Felony,118,91,240,118,134,701
Suffolk,2013,Misdemeanor,0,126,1160,409,547,2242
Sullivan,2013,Felony,4,13,45,41,12,115
Sullivan,2013,Misdemeanor,0,13,17,35,65,130
Tioga,2013,Felony,2,5,8,11,7,33
Tioga,2013,Misdemeanor,0,7,5,22,18,52
Tompkins,2013,Felony,5,4,24,13,23,69
Tompkins,2013,Misdemeanor,0,16,56,39,58,169
Ulster,2013,Felony,5,10,42,17,22,96
Ulster,2013,Misdemeanor,0,23,34,94,94,245
Warren,2013,Felony,3,14,18,21,12,68
Warren,2013,Misdemeanor,0,14,45,72,91,222
Washington,2013,Felony,3,0,3,23,13,42
Washington,2013,Misdemeanor,0,6,24,26,40,96
Wayne,2013,Felony,13,11,42,15,16,97
Wayne,2013,Misdemeanor,0,7,18,50,52,127
Westchester,2013,Felony,109,56,109,43,93,410
Westchester,2013,Misdemeanor,0,271,247,431,569,1518
Wyoming,2013,Felony,4,6,19,15,14,58
Wyoming,2013,Misdemeanor,0,7,27,17,24,75
Yates,2013,Felony,0,3,12,14,10,39
Yates,2013,Misdemeanor,0,7,14,9,11,41
Unknown,2013,Misdemeanor,0,0,0,0,0,0
Albany,2014,Felony,12,42,81,70,94,299
Albany,2014,Misdemeanor,0,70,97,240,279,686
Allegany,2014,Felony,4,8,2,7,6,27
Allegany,2014,Misdemeanor,0,15,13,18,36,82
Bronx,2014,Felony,250,90,29,71,130,570
Bronx,2014,Misdemeanor,0,30,85,172,269,556
Broome,2014,Felony,66,38,52,92,92,340
Broome,2014,Misdemeanor,0,66,37,153,136,392
Cattaraugus,2014,Felony,3,21,31,25,17,97
Cattaraugus,2014,Misdemeanor,0,17,18,40,58,133
Cayuga,2014,Felony,5,17,15,21,28,86
Cayuga,2014,Misdemeanor,0,18,42,69,69,198
Chautauqua,2014,Felony,10,13,35,23,25,106
Chautauqua,2014,Misdemeanor,0,23,44,106,142,315
Chemung,2014,Felony,11,12,34,39,17,113
Chemung,2014,Misdemeanor,0,22,24,49,42,137
Chenango,2014,Felony,7,10,7,7,11,42
Chenango,2014,Misdemeanor,0,15,10,19,19,63
Clinton,2014,Felony,8,19,23,27,20,97
Clinton,2014,Misdemeanor,0,14,19,35,73,141
Columbia,2014,Felony,2,3,16,8,7,36
Columbia,2014,Misdemeanor,0,8,6,15,21,50
Cortland,2014,Felony,3,13,13,13,10,52
Cortland,2014,Misdemeanor,0,11,26,37,56,130
Delaware,2014,Felony,2,14,3,7,6,32
Delaware,2014,Misdemeanor,0,7,6,25,12,50
Dutchess,2014,Felony,7,21,41,46,52,167
Dutchess,2014,Misdemeanor,0,65,123,174,153,515
Erie,2014,Felony,96,76,225,73,76,546
Erie,2014,Misdemeanor,0,55,119,180,224,578
Essex,2014,Felony,2,9,10,11,4,36
Essex,2014,Misdemeanor,0,6,9,25,38,78
Franklin,2014,Felony,4,18,8,15,7,52
Franklin,2014,Misdemeanor,0,27,17,20,40,104
Fulton,2014,Felony,1,10,4,19,13,47
Fulton,2014,Misdemeanor,0,6,13,35,19,73
Genesee,2014,Felony,3,5,47,29,12,96
Genesee,2014,Misdemeanor,0,10,39,47,51,147
Greene,2014,Felony,2,13,13,12,4,44
Greene,2014,Misdemeanor,0,10,24,29,41,104
Hamilton,2014,Felony,0,0,2,2,0,4
Hamilton,2014,Misdemeanor,0,0,1,5,4,10
Herkimer,2014,Felony,2,3,17,11,11,44
Herkimer,2014,Misdemeanor,0,3,14,24,37,78
Jefferson,2014,Felony,24,40,16,64,27,171
Jefferson,2014,Misdemeanor,0,18,31,107,115,271
Kings,2014,Felony,143,71,49,73,164,500
Kings,2014,Misdemeanor,0,65,74,80,247,466
Lewis,2014,Felony,0,2,6,5,1,14
Lewis,2014,Misdemeanor,0,4,8,7,12,31
Livingston,2014,Felony,1,13,32,17,20,83
Livingston,2014,Misdemeanor,0,20,19,29,53,121
Madison,2014,Felony,6,4,11,10,6,37
Madison,2014,Misdemeanor,0,8,16,21,48,93
Monroe,2014,Felony,134,32,196,56,115,533
Monroe,2014,Misdemeanor,0,113,405,364,358,1240
Montgomery,2014,Felony,1,21,20,11,4,57
Montgomery,2014,Misdemeanor,0,6,4,18,14,42
Nassau,2014,Felony,107,38,188,66,87,486
Nassau,2014,Misdemeanor,0,113,836,253,364,1566
New York,2014,Felony,179,413,45,271,322,1230
New York,2014,Misdemeanor,0,104,18,115,273,510
Niagara,2014,Felony,12,22,15,14,20,83
Niagara,2014,Misdemeanor,0,24,64,82,73,243
Oneida,2014,Felony,24,23,83,43,48,221
Oneida,2014,Misdemeanor,0,31,53,102,145,331
Onondaga,2014,Felony,53,79,48,79,87,346
Onondaga,2014,Misdemeanor,0,155,218,421,410,1204
Ontario,2014,Felony,19,18,81,36,41,195
Ontario,2014,Misdemeanor,0,17,29,90,69,205
Orange,2014,Felony,26,68,118,56,53,321
Orange,2014,Misdemeanor,0,58,130,128,116,432
Orleans,2014,Felony,1,7,3,1,1,13
Orleans,2014,Misdemeanor,0,5,11,17,16,49
Oswego,2014,Felony,6,23,17,24,23,93
Oswego,2014,Misdemeanor,0,39,55,87,76,257
Otsego,2014,Felony,1,8,6,8,2,25
Otsego,2014,Misdemeanor,0,6,8,7,22,43
Putnam,2014,Felony,2,17,17,4,2,42
Putnam,2014,Misdemeanor,0,14,33,28,16,91
Queens,2014,Felony,208,68,72,121,148,617
Queens,2014,Misdemeanor,0,34,141,166,156,497
Rensselaer,2014,Felony,10,21,18,20,27,96
Rensselaer,2014,Misdemeanor,0,25,21,74,99,219
Richmond,2014,Felony,38,46,3,23,23,133
Richmond,2014,Misdemeanor,0,27,31,76,60,194
Rockland,2014,Felony,21,25,25,53,51,175
Rockland,2014,Misdemeanor,0,28,49,57,34,168
St. Lawrence,2014,Felony,12,20,30,13,22,97
St. Lawrence,2014,Misdemeanor,0,13,30,34,46,123
Saratoga,2014,Felony,2,20,57,32,37,148
Saratoga,2014,Misdemeanor,0,20,46,93,86,245
Schenectady,2014,Felony,8,17,32,31,33,121
Schenectady,2014,Misdemeanor,0,12,27,105,97,241
Schoharie,2014,Felony,1,0,10,2,3,16
Schoharie,2014,Misdemeanor,0,5,6,10,16,37
Schuyler,2014,Felony,4,4,9,11,4,32
Schuyler,2014,Misdemeanor,0,2,5,9,8,24
Seneca,2014,Felony,2,12,18,8,19,59
Seneca,2014,Misdemeanor,0,4,8,20,18,50
Steuben,2014,Felony,11,11,30,27,41,120
Steuben,2014,Misdemeanor,0,16,14,55,74,159
Suffolk,2014,Felony,89,57,253,112,119,630
Suffolk,2014,Misdemeanor,0,126,1015,374,465,1980
Sullivan,2014,Felony,7,8,25,35,28,103
Sullivan,2014,Misdemeanor,0,16,36,30,40,122
Tioga,2014,Felony,0,7,11,5,10,33
Tioga,2014,Misdemeanor,0,6,5,14,12,37
Tompkins,2014,Felony,10,2,33,14,22,81
Tompkins,2014,Misdemeanor,0,12,44,43,47,146
Ulster,2014,Felony,2,16,39,20,15,92
Ulster,2014,Misdemeanor,0,39,33,103,114,289
Warren,2014,Felony,3,16,20,20,19,78
Warren,2014,Misdemeanor,0,14,18,45,53,130
Washington,2014,Felony,1,2,5,10,16,34
Washington,2014,Misdemeanor,0,10,11,50,57,128
Wayne,2014,Felony,19,3,32,13,10,77
Wayne,2014,Misdemeanor,0,7,26,40,47,120
Westchester,2014,Felony,84,59,110,46,117,416
Westchester,2014,Misdemeanor,0,244,233,393,542,1412
Wyoming,2014,Felony,5,12,17,7,9,50
Wyoming,2014,Misdemeanor,0,10,18,18,23,69
Yates,2014,Felony,0,1,4,4,5,14
Yates,2014,Misdemeanor,0,7,8,13,18,46
Unknown,2014,Misdemeanor,0,0,0,0,0,0
Albany,2015,Felony,7,45,101,42,89,284
Albany,2015,Misdemeanor,0,45,98,216,236,595
Allegany,2015,Felony,1,10,7,5,8,31
Allegany,2015,Misdemeanor,0,8,10,14,35,67
Bronx,2015,Felony,157,57,35,40,147,436
Bronx,2015,Misdemeanor,0,25,92,125,254,496
Broome,2015,Felony,48,29,62,86,74,299
Broome,2015,Misdemeanor,0,72,56,140,135,403
Cattaraugus,2015,Felony,1,34,44,42,24,145
Cattaraugus,2015,Misdemeanor,0,9,19,37,40,105
Cayuga,2015,Felony,4,20,16,17,17,74
Cayuga,2015,Misdemeanor,0,21,38,59,79,197
Chautauqua,2015,Felony,9,32,17,33,23,114
Chautauqua,2015,Misdemeanor,0,30,40,73,139,282
Chemung,2015,Felony,9,8,35,37,15,104
Chemung,2015,Misdemeanor,0,18,26,42,48,134
Chenango,2015,Felony,7,13,10,8,12,50
Chenango,2015,Misdemeanor,0,14,8,24,29,75
Clinton,2015,Felony,7,22,23,19,27,98
Clinton,2015,Misdemeanor,0,19,24,41,47,131
Columbia,2015,Felony,5,4,12,14,9,44
Columbia,2015,Misdemeanor,0,7,5,8,18,38
Cortland,2015,Felony,2,26,12,16,16,72
Cortland,2015,Misdemeanor,0,17,31,40,47,135
Delaware,2015,Felony,2,11,15,5,8,41
Delaware,2015,Misdemeanor,0,11,8,16,18,53
Dutchess,2015,Felony,4,29,45,38,44,160
Dutchess,2015,Misdemeanor,0,47,101,161,156,465
Erie,2015,Felony,82,47,253,75,102,559
Erie,2015,Misdemeanor,0,51,129,175,186,541
Essex,2015,Felony,1,18,5,2,4,30
Essex,2015,Misdemeanor,0,5,9,17,32,63
Franklin,2015,Felony,4,17,19,9,12,61
Franklin,2015,Misdemeanor,0,8,16,23,31,78
Fulton,2015,Felony,1,4,8,18,7,38
Fulton,2015,Misdemeanor,0,2,9,47,33,91
Genesee,2015,Felony,4,9,22,22,18,75
Genesee,2015,Misdemeanor,0,19,36,56,67,178
Greene,2015,Felony,1,10,18,6,5,40
Greene,2015,Misdemeanor,0,2,8,23,21,54
Hamilton,2015,Felony,0,1,0,2,0,3
Hamilton,2015,Misdemeanor,0,0,1,2,3,6
Herkimer,2015,Felony,3,1,8,12,10,34
Herkimer,2015,Misdemeanor,0,8,9,25,23,65
Jefferson,2015,Felony,10,40,17,41,26,134
Jefferson,2015,Misdemeanor,0,18,15,102,118,253
Kings,2015,Felony,109,52,51,42,147,401
Kings,2015,Misdemeanor,0,39,81,58,213,391
Lewis,2015,Felony,3,2,7,6,1,19
Lewis,2015,Misdemeanor,0,4,9,8,9,30
Livingston,2015,Felony,4,12,36,10,43,105
Livingston,2015,Misdemeanor,0,15,18,30,35,98
Madison,2015,Felony,10,5,14,8,9,46
Madison,2015,Misdemeanor,0,12,7,27,18,64
Monroe,2015,Felony,111,29,166,52,107,465
Monroe,2015,Misdemeanor,0,95,379,312,327,1113
Montgomery,2015,Felony,4,14,16,16,13,63
Montgomery,2015,Misdemeanor,0,3,5,21,27,56
Nassau,2015,Felony,90,45,221,55,96,507
Nassau,2015,Misdemeanor,0,73,720,207,309,1309
New York,2015,Felony,172,390,27,213,287,1089
New York,2015,Misdemeanor,0,88,19,127,204,438
Niagara,2015,Felony,13,16,15,9,18,71
Niagara,2015,Misdemeanor,0,24,70,89,85,268
Oneida,2015,Felony,19,35,52,30,32,168
Oneida,2015,Misdemeanor,0,30,59,108,136,333
Onondaga,2015,Felony,62,76,54,91,89,372
Onondaga,2015,Misdemeanor,0,175,199,422,434,1230
Ontario,2015,Felony,15,14,56,46,49,180
Ontario,2015,Misdemeanor,0,17,54,86,91,248
Orange,2015,Felony,23,53,100,40,33,249
Orange,2015,Misdemeanor,0,45,167,114,123,449
Orleans,2015,Felony,3,6,2,2,1,14
Orleans,2015,Misdemeanor,0,4,11,22,24,61
Oswego,2015,Felony,2,18,15,36,32,103
Oswego,2015,Misdemeanor,0,38,49,80,66,233
Otsego,2015,Felony,0,6,7,11,4,28
Otsego,2015,Misdemeanor,0,6,7,9,14,36
Putnam,2015,Felony,8,13,9,2,3,35
Putnam,2015,Misdemeanor,0,11,29,24,17,81
Queens,2015,Felony,164,82,69,121,163,599
Queens,2015,Misdemeanor,0,48,109,153,163,473
Rensselaer,2015,Felony,5,14,21,20,25,85
Rensselaer,2015,Misdemeanor,0,15,17,55,92,179
Richmond,2015,Felony,43,62,1,26,28,160
Richmond,2015,Misdemeanor,0,31,38,70,46,185
Rockland,2015,Felony,18,18,24,53,58,171
Rockland,2015,Misdemeanor,0,28,31,45,41,145
St. Lawrence,2015,Felony,6,30,23,7,7,73
St. Lawrence,2015,Misdemeanor,0,5,28,34,39,106
Saratoga,2015,Felony,5,27,41,16,15,104
Saratoga,2015,Misdemeanor,0,15,55,68,74,212
Schenectady,2015,Felony,11,27,28,22,21,109
Schenectady,2015,Misdemeanor,0,13,21,74,79,187
Schoharie,2015,Felony,0,0,5,9,7,21
Schoharie,2015,Misdemeanor,0,4,8,7,8,27
Schuyler,2015,Felony,1,2,4,7,4,18
Schuyler,2015,Misdemeanor,0,0,1,6,6,13
Seneca,2015,Felony,0,9,22,10,9,50
Seneca,2015,Misdemeanor,0,1,7,17,25,50
Steuben,2015,Felony,10,11,29,30,35,115
Steuben,2015,Misdemeanor,0,19,20,44,68,151
Suffolk,2015,Felony,90,86,212,103,144,635
Suffolk,2015,Misdemeanor,0,103,675,292,345,1415
Sullivan,2015,Felony,3,6,23,26,24,82
Sullivan,2015,Misdemeanor,0,9,24,54,42,129
Tioga,2015,Felony,3,9,7,5,9,33
Tioga,2015,Misdemeanor,0,8,9,11,18,46
Tompkins,2015,Felony,5,2,29,19,21,76
Tompkins,2015,Misdemeanor,0,13,35,71,49,168
Ulster,2015,Felony,4,18,36,21,14,93
Ulster,2015,Misdemeanor,0,38,38,78,91,245
Warren,2015,Felony,5,14,20,12,15,66
Warren,2015,Misdemeanor,0,10,36,42,68,156
Washington,2015,Felony,3,3,6,11,9,32
Washington,2015,Misdemeanor,0,6,17,18,47,88
Wayne,2015,Felony,8,6,41,9,13,77
Wayne,2015,Misdemeanor,0,9,29,46,37,121
Westchester,2015,Felony,83,51,98,58,149,439
Westchester,2015,Misdemeanor,0,190,240,333,468,1231
Wyoming,2015,Felony,0,10,6,2,11,29
Wyoming,2015,Misdemeanor,0,4,17,10,23,54
Yates,2015,Felony,0,0,15,7,7,29
Yates,2015,Misdemeanor,0,7,4,15,12,38
Unknown,2015,Misdemeanor,0,0,0,0,0,0
Albany,2016,Felony,8,58,81,34,97,278
Albany,2016,Misdemeanor,0,46,105,208,206,565
Allegany,2016,Felony,5,6,4,5,7,27
Allegany,2016,Misdemeanor,0,7,14,16,31,68
Bronx,2016,Felony,196,66,37,30,137,466
Bronx,2016,Misdemeanor,0,33,88,110,337,568
Broome,2016,Felony,65,48,42,61,52,268
Broome,2016,Misdemeanor,0,56,50,133,117,356
Cattaraugus,2016,Felony,2,17,17,15,18,69
Cattaraugus,2016,Misdemeanor,0,9,29,44,49,131
Cayuga,2016,Felony,5,9,16,8,15,53
Cayuga,2016,Misdemeanor,0,16,43,53,69,181
Chautauqua,2016,Felony,7,19,24,20,16,86
Chautauqua,2016,Misdemeanor,0,39,38,112,148,337
Chemung,2016,Felony,3,17,41,36,14,111
Chemung,2016,Misdemeanor,0,31,23,45,49,148
Chenango,2016,Felony,3,12,4,8,12,39
Chenango,2016,Misdemeanor,0,9,7,14,28,58
Clinton,2016,Felony,8,24,30,16,27,105
Clinton,2016,Misdemeanor,0,22,27,43,49,141
Columbia,2016,Felony,2,10,19,12,6,49
Columbia,2016,Misdemeanor,0,10,3,8,13,34
Cortland,2016,Felony,0,15,11,18,12,56
Cortland,2016,Misdemeanor,0,20,13,46,69,148
Delaware,2016,Felony,1,18,1,7,3,30
Delaware,2016,Misdemeanor,0,8,8,11,15,42
Dutchess,2016,Felony,6,24,27,37,37,131
Dutchess,2016,Misdemeanor,0,30,88,142,153,413
Erie,2016,Felony,126,50,170,75,113,534
Erie,2016,Misdemeanor,0,87,126,179,177,569
Essex,2016,Felony,0,15,4,4,3,26
Essex,2016,Misdemeanor,0,5,14,16,30,65
Franklin,2016,Felony,3,8,18,13,4,46
Franklin,2016,Misdemeanor,0,5,23,26,32,86
Fulton,2016,Felony,1,6,2,11,7,27
Fulton,2016,Misdemeanor,0,12,12,30,35,89
Genesee,2016,Felony,4,8,30,12,21,75
Genesee,2016,Misdemeanor,0,9,44,46,65,164
Greene,2016,Felony,2,10,10,9,11,42
Greene,2016,Misdemeanor,0,11,16,4,20,51
Hamilton,2016,Felony,0,0,1,1,1,3
Hamilton,2016,Misdemeanor,0,0,0,0,1,1
Herkimer,2016,Felony,3,0,13,11,6,33
Herkimer,2016,Misdemeanor,0,8,11,27,26,72
Jefferson,2016,Felony,17,46,20,36,17,136
Jefferson,2016,Misdemeanor,0,13,20,94,116,243
Kings,2016,Felony,120,81,53,56,206,516
Kings,2016,Misdemeanor,0,65,62,72,221,420
Lewis,2016,Felony,3,8,9,9,5,34
Lewis,2016,Misdemeanor,0,6,4,11,10,31
Livingston,2016,Felony,7,11,35,14,21,88
Livingston,2016,Misdemeanor,0,19,29,18,34,100
Madison,2016,Felony,6,6,9,14,13,48
Madison,2016,Misdemeanor,0,5,10,24,30,69
Monroe,2016,Felony,140,41,231,63,143,618
Monroe,2016,Misdemeanor,0,106,394,299,398,1197
Montgomery,2016,Felony,5,9,10,18,9,51
Montgomery,2016,Misdemeanor,0,10,3,26,23,62
Nassau,2016,Felony,81,65,193,48,130,517
Nassau,2016,Misdemeanor,0,151,745,179,363,1438
New York,2016,Felony,196,420,45,245,281,1187
New York,2016,Misdemeanor,0,90,10,122,265,487
Niagara,2016,Felony,12,15,17,11,17,72
Niagara,2016,Misdemeanor,0,38,62,83,110,293
Oneida,2016,Felony,24,42,31,31,36,164
Oneida,2016,Misdemeanor,0,47,46,121,138,352
Onondaga,2016,Felony,39,59,43,71,114,326
Onondaga,2016,Misdemeanor,0,250,205,382,380,1217
Ontario,2016,Felony,16,10,69,32,37,164
Ontario,2016,Misdemeanor,0,12,45,64,62,183
Orange,2016,Felony,13,60,76,54,55,258
Orange,2016,Misdemeanor,0,40,205,105,110,460
Orleans,2016,Felony,4,9,0,4,4,21
Orleans,2016,Misdemeanor,0,7,18,31,6,62
Oswego,2016,Felony,8,27,16,22,36,109
Oswego,2016,Misdemeanor,0,32,35,72,61,200
Otsego,2016,Felony,3,11,10,3,5,32
Otsego,2016,Misdemeanor,0,8,10,9,16,43
Putnam,2016,Felony,5,2,11,1,2,21
Putnam,2016,Misdemeanor,0,20,15,15,14,64
Queens,2016,Felony,162,58,73,94,153,540
Queens,2016,Misdemeanor,0,47,112,121,159,439
Rensselaer,2016,Felony,3,24,30,10,20,87
Rensselaer,2016,Misdemeanor,0,21,22,52,76,171
Richmond,2016,Felony,30,29,3,28,26,116
Richmond,2016,Misdemeanor,0,17,58,40,54,169
Rockland,2016,Felony,24,17,50,62,64,217
Rockland,2016,Misdemeanor,0,17,46,44,58,165
St. Lawrence,2016,Felony,7,48,22,18,20,115
St. Lawrence,2016,Misdemeanor,0,20,24,33,30,107
Saratoga,2016,Felony,7,10,49,28,30,124
Saratoga,2016,Misdemeanor,0,25,62,65,90,242
Schenectady,2016,Felony,5,24,17,17,18,81
Schenectady,2016,Misdemeanor,0,10,33,95,64,202
Schoharie,2016,Felony,1,1,14,6,8,30
Schoharie,2016,Misdemeanor,0,5,5,9,14,33
Schuyler,2016,Felony,0,4,10,1,5,20
Schuyler,2016,Misdemeanor,0,2,3,3,4,12
Seneca,2016,Felony,1,7,25,10,13,56
Seneca,2016,Misdemeanor,0,9,12,26,28,75
Steuben,2016,Felony,7,18,29,32,40,126
Steuben,2016,Misdemeanor,0,22,14,46,71,153
Suffolk,2016,Felony,75,57,286,78,124,620
Suffolk,2016,Misdemeanor,0,100,586,289,314,1289
Sullivan,2016,Felony,4,6,28,16,15,69
Sullivan,2016,Misdemeanor,0,11,30,45,46,132
Tioga,2016,Felony,4,3,5,8,7,27
Tioga,2016,Misdemeanor,0,11,4,18,28,61
Tompkins,2016,Felony,10,5,21,21,16,73
Tompkins,2016,Misdemeanor,0,8,41,42,44,135
Ulster,2016,Felony,1,4,49,15,20,89
Ulster,2016,Misdemeanor,0,50,41,125,104,320
Warren,2016,Felony,7,15,13,15,22,72
Warren,2016,Misdemeanor,0,20,14,48,55,137
Washington,2016,Felony,5,9,6,9,14,43
Washington,2016,Misdemeanor,0,9,14,27,23,73
Wayne,2016,Felony,5,12,28,10,11,66
Wayne,2016,Misdemeanor,0,6,21,46,65,138
Westchester,2016,Felony,79,36,83,51,131,380
Westchester,2016,Misdemeanor,0,169,243,346,511,1269
Wyoming,2016,Felony,2,10,5,5,15,37
Wyoming,2016,Misdemeanor,0,6,11,13,23,53
Yates,2016,Felony,1,6,10,1,11,29
Yates,2016,Misdemeanor,0,8,4,8,20,40
Unknown,2016,Misdemeanor,0,0,0,0,0,0
Albany,2017,Felony,14,54,88,34,109,299
Albany,2017,Misdemeanor,0,39,114,167,211,531
Allegany,2017,Felony,2,8,9,9,6,34
Allegany,2017,Misdemeanor,0,7,19,22,25,73
Bronx,2017,Felony,174,53,34,46,171,478
Bronx,2017,Misdemeanor,0,59,73,95,302,529
Broome,2017,Felony,45,43,33,46,59,226
Broome,2017,Misdemeanor,0,107,38,139,133,417
Cattaraugus,2017,Felony,1,22,20,13,20,76
Cattaraugus,2017,Misdemeanor,0,20,35,38,51,144
Cayuga,2017,Felony,0,17,21,9,19,66
Cayuga,2017,Misdemeanor,0,9,32,44,53,138
Chautauqua,2017,Felony,7,16,18,18,21,80
Chautauqua,2017,Misdemeanor,0,45,22,69,120,256
Chemung,2017,Felony,7,7,31,18,25,88
Chemung,2017,Misdemeanor,0,16,24,44,56,140
Chenango,2017,Felony,7,15,6,10,11,49
Chenango,2017,Misdemeanor,0,3,2,12,15,32
Clinton,2017,Felony,1,12,30,23,16,82
Clinton,2017,Misdemeanor,0,15,25,49,50,139
Columbia,2017,Felony,5,2,20,14,16,57
Columbia,2017,Misdemeanor,0,11,4,16,16,47
Cortland,2017,Felony,2,19,15,9,8,53
Cortland,2017,Misdemeanor,0,20,40,44,61,165
Delaware,2017,Felony,1,22,9,9,5,46
Delaware,2017,Misdemeanor,0,7,2,5,18,32
Dutchess,2017,Felony,3,35,32,31,48,149
Dutchess,2017,Misdemeanor,0,47,139,147,147,480
Erie,2017,Felony,112,57,120,71,96,456
Erie,2017,Misdemeanor,0,55,117,162,188,522
Essex,2017,Felony,0,5,3,1,3,12
Essex,2017,Misdemeanor,0,4,7,13,27,51
Franklin,2017,Felony,1,18,7,9,12,47
Franklin,2017,Misdemeanor,0,18,23,30,37,108
Fulton,2017,Felony,0,2,12,12,14,40
Fulton,2017,Misdemeanor,0,9,5,18,50,82
Genesee,2017,Felony,12,13,18,18,15,76
Genesee,2017,Misdemeanor,0,22,43,43,64,172
Greene,2017,Felony,1,3,8,4,8,24
Greene,2017,Misdemeanor,0,11,14,14,13,52
Hamilton,2017,Felony,0,0,1,0,1,2
Hamilton,2017,Misdemeanor,0,0,2,1,6,9
Herkimer,2017,Felony,0,0,7,15,10,32
Herkimer,2017,Misdemeanor,0,9,10,17,30,66
Jefferson,2017,Felony,3,37,19,41,34,134
Jefferson,2017,Misdemeanor,0,13,20,67,88,188
Kings,2017,Felony,113,79,36,63,281,572
Kings,2017,Misdemeanor,0,63,66,48,278,455
Lewis,2017,Felony,2,8,5,2,4,21
Lewis,2017,Misdemeanor,0,3,10,5,17,35
Livingston,2017,Felony,3,13,35,14,31,96
Livingston,2017,Misdemeanor,0,26,25,20,44,115
Madison,2017,Felony,6,6,11,6,12,41
Madison,2017,Misdemeanor,0,10,11,36,27,84
Monroe,2017,Felony,161,50,183,50,169,613
Monroe,2017,Misdemeanor,0,141,423,290,375,1229
Montgomery,2017,Felony,1,13,14,17,7,52
Montgomery,2017,Misdemeanor,0,7,5,20,28,60
Nassau,2017,Felony,73,91,227,59,154,604
Nassau,2017,Misdemeanor,0,147,880,177,360,1564
New York,2017,Felony,189,378,30,192,273,1062
New York,2017,Misdemeanor,0,90,13,100,237,440
Niagara,2017,Felony,18,21,12,14,24,89
Niagara,2017,Misdemeanor,0,31,72,68,104,275
Oneida,2017,Felony,23,29,42,23,44,161
Oneida,2017,Misdemeanor,0,33,60,96,163,352
Onondaga,2017,Felony,51,69,62,74,100,356
Onondaga,2017,Misdemeanor,0,199,206,320,321,1046
Ontario,2017,Felony,26,5,59,30,45,165
Ontario,2017,Misdemeanor,0,20,60,103,78,261
Orange,2017,Felony,13,62,98,49,53,275
Orange,2017,Misdemeanor,0,60,177,92,132,461
Orleans,2017,Felony,1,2,4,1,3,11
Orleans,2017,Misdemeanor,0,4,16,11,18,49
Oswego,2017,Felony,6,22,15,21,37,101
Oswego,2017,Misdemeanor,0,37,59,59,69,224
Otsego,2017,Felony,1,11,8,12,5,37
Otsego,2017,Misdemeanor,0,2,2,14,13,31
Putnam,2017,Felony,3,5,8,4,3,23
Putnam,2017,Misdemeanor,0,18,36,9,21,84
Queens,2017,Felony,129,48,63,93,172,505
Queens,2017,Misdemeanor,0,43,86,113,163,405
Rensselaer,2017,Felony,1,16,33,11,21,82
Rensselaer,2017,Misdemeanor,0,5,22,45,53,125
Richmond,2017,Felony,20,31,7,17,44,119
Richmond,2017,Misdemeanor,0,24,39,34,78,175
Rockland,2017,Felony,14,15,27,42,46,144
Rockland,2017,Misdemeanor,0,18,62,43,41,164
St. Lawrence,2017,Felony,3,21,16,10,22,72
St. Lawrence,2017,Misdemeanor,0,12,14,20,37,83
Saratoga,2017,Felony,5,14,49,23,30,121
Saratoga,2017,Misdemeanor,0,21,49,56,84,210
Schenectady,2017,Felony,3,22,25,13,23,86
Schenectady,2017,Misdemeanor,0,9,19,61,54,143
Schoharie,2017,Felony,3,6,6,6,9,30
Schoharie,2017,Misdemeanor,0,3,4,15,11,33
Schuyler,2017,Felony,2,4,8,7,6,27
Schuyler,2017,Misdemeanor,0,3,5,4,10,22
Seneca,2017,Felony,2,6,21,6,5,40
Seneca,2017,Misdemeanor,0,10,11,17,15,53
Steuben,2017,Felony,5,10,37,17,35,104
Steuben,2017,Misdemeanor,0,23,29,38,71,161
Suffolk,2017,Felony,68,89,263,47,121,588
Suffolk,2017,Misdemeanor,0,98,621,303,337,1359
Sullivan,2017,Felony,8,5,15,28,18,74
Sullivan,2017,Misdemeanor,0,10,14,27,38,89
Tioga,2017,Felony,3,3,11,3,3,23
Tioga,2017,Misdemeanor,0,3,16,14,12,45
Tompkins,2017,Felony,3,3,12,11,10,39
Tompkins,2017,Misdemeanor,0,11,35,37,53,136
Ulster,2017,Felony,2,12,39,9,18,80
Ulster,2017,Misdemeanor,0,47,44,88,123,302
Warren,2017,Felony,9,17,14,14,16,70
Warren,2017,Misdemeanor,0,15,34,47,77,173
Washington,2017,Felony,3,7,8,7,13,38
Washington,2017,Misdemeanor,0,7,17,16,32,72
Wayne,2017,Felony,8,6,30,10,17,71
Wayne,2017,Misdemeanor,0,6,14,30,31,81
Westchester,2017,Felony,65,38,103,68,159,433
Westchester,2017,Misdemeanor,0,155,248,345,500,1248
Wyoming,2017,Felony,3,13,4,8,16,44
Wyoming,2017,Misdemeanor,0,8,15,15,21,59
Yates,2017,Felony,0,7,4,4,8,23
Yates,2017,Misdemeanor,0,7,4,9,18,38
Unknown,2017,Misdemeanor,0,0,0,0,0,0
Albany,2018,Felony,15,48,86,30,89,268
Albany,2018,Misdemeanor,0,39,115,90,195,439
Allegany,2018,Felony,3,16,8,6,9,42
Allegany,2018,Misdemeanor,0,8,8,11,39,66
Bronx,2018,Felony,124,54,19,30,115,342
Bronx,2018,Misdemeanor,0,57,48,71,230,406
Broome,2018,Felony,33,32,22,23,75,185
Broome,2018,Misdemeanor,0,89,16,116,115,336
Cattaraugus,2018,Felony,0,18,28,12,17,75
Cattaraugus,2018,Misdemeanor,0,20,31,48,39,138
Cayuga,2018,Felony,4,8,7,8,21,48
Cayuga,2018,Misdemeanor,0,14,25,41,64,144
Chautauqua,2018,Felony,9,33,12,14,16,84
Chautauqua,2018,Misdemeanor,0,56,31,63,142,292
Chemung,2018,Felony,8,12,21,17,22,80
Chemung,2018,Misdemeanor,0,31,15,39,34,119
Chenango,2018,Felony,5,10,6,6,8,35
Chenango,2018,Misdemeanor,0,12,10,13,23,58
Clinton,2018,Felony,6,14,33,16,25,94
Clinton,2018,Misdemeanor,0,12,43,42,72,169
Columbia,2018,Felony,5,8,15,13,8,49
Columbia,2018,Misdemeanor,0,5,2,8,11,26
Cortland,2018,Felony,0,7,7,10,10,34
Cortland,2018,Misdemeanor,0,25,35,52,52,164
Delaware,2018,Felony,3,13,1,6,3,26
Delaware,2018,Misdemeanor,0,1,9,9,17,36
Dutchess,2018,Felony,3,30,31,20,43,127
Dutchess,2018,Misdemeanor,0,54,141,96,137,428
Erie,2018,Felony,131,64,87,71,105,458
Erie,2018,Misdemeanor,0,37,95,162,221,515
Essex,2018,Felony,0,0,5,1,5,11
Essex,2018,Misdemeanor,0,6,4,14,16,40
Franklin,2018,Felony,6,16,11,5,9,47
Franklin,2018,Misdemeanor,0,11,18,24,45,98
Fulton,2018,Felony,0,4,4,9,22,39
Fulton,2018,Misdemeanor,0,15,15,35,54,119
Genesee,2018,Felony,13,8,21,28,30,100
Genesee,2018,Misdemeanor,0,20,51,40,50,161
Greene,2018,Felony,2,7,11,11,7,38
Greene,2018,Misdemeanor,0,8,15,10,22,55
Hamilton,2018,Felony,1,2,1,0,0,4
Hamilton,2018,Misdemeanor,0,0,4,0,2,6
Herkimer,2018,Felony,4,2,8,6,6,26
Herkimer,2018,Misdemeanor,0,2,10,16,30,58
Jefferson,2018,Felony,13,45,15,23,53,149
Jefferson,2018,Misdemeanor,0,16,21,88,82,207
Kings,2018,Felony,98,37,25,31,199,390
Kings,2018,Misdemeanor,0,65,43,58,214,380
Lewis,2018,Felony,1,7,7,5,2,22
Lewis,2018,Misdemeanor,0,12,11,11,13,47
Livingston,2018,Felony,3,8,31,17,23,82
Livingston,2018,Misdemeanor,0,17,29,14,41,101
Madison,2018,Felony,14,4,5,11,14,48
Madison,2018,Misdemeanor,0,12,22,25,40,99
Monroe,2018,Felony,145,31,167,50,98,491
Monroe,2018,Misdemeanor,0,146,417,350,338,1251
Montgomery,2018,Felony,1,3,14,20,20,58
Montgomery,2018,Misdemeanor,0,15,5,34,43,97
Nassau,2018,Felony,57,69,214,38,156,534
Nassau,2018,Misdemeanor,0,174,762,194,381,1511
New York,2018,Felony,131,288,28,165,195,807
New York,2018,Misdemeanor,0,58,14,104,184,360
Niagara,2018,Felony,15,20,14,7,21,77
Niagara,2018,Misdemeanor,0,32,76,60,115,283
Oneida,2018,Felony,18,23,29,24,40,134
Oneida,2018,Misdemeanor,0,32,53,83,141,309
Onondaga,2018,Felony,45,64,62,81,92,344
Onondaga,2018,Misdemeanor,0,204,209,242,291,946
Ontario,2018,Felony,15,30,56,37,40,178
Ontario,2018,Misdemeanor,0,32,36,87,78,233
Orange,2018,Felony,11,54,82,35,40,222
Orange,2018,Misdemeanor,0,36,155,69,96,356
Orleans,2018,Felony,0,5,5,4,7,21
Orleans,2018,Misdemeanor,0,2,17,16,10,45
Oswego,2018,Felony,9,9,15,12,24,69
Oswego,2018,Misdemeanor,0,28,49,78,61,216
Otsego,2018,Felony,2,10,7,6,8,33
Otsego,2018,Misdemeanor,0,9,4,22,13,48
Putnam,2018,Felony,2,6,15,0,6,29
Putnam,2018,Misdemeanor,0,14,23,9,18,64
Queens,2018,Felony,140,42,60,72,160,474
Queens,2018,Misdemeanor,0,26,83,96,165,370
Rensselaer,2018,Felony,1,31,13,8,19,72
Rensselaer,2018,Misdemeanor,0,15,25,33,48,121
Richmond,2018,Felony,28,41,5,20,39,133
Richmond,2018,Misdemeanor,0,16,40,78,97,231
Rockland,2018,Felony,13,17,32,57,45,164
Rockland,2018,Misdemeanor,0,19,50,34,33,136
St. Lawrence,2018,Felony,3,17,16,9,9,54
St. Lawrence,2018,Misdemeanor,0,9,9,21,30,69
Saratoga,2018,Felony,4,11,46,32,40,133
Saratoga,2018,Misdemeanor,0,20,59,67,97,243
Schenectady,2018,Felony,9,23,21,22,14,89
Schenectady,2018,Misdemeanor,0,13,16,76,60,165
Schoharie,2018,Felony,1,4,8,1,2,16
Schoharie,2018,Misdemeanor,0,3,3,8,12,26
Schuyler,2018,Felony,1,3,11,1,4,20
Schuyler,2018,Misdemeanor,0,1,8,5,11,25
Seneca,2018,Felony,2,9,19,17,13,60
Seneca,2018,Misdemeanor,0,11,7,20,33,71
Steuben,2018,Felony,4,24,22,33,30,113
Steuben,2018,Misdemeanor,0,22,22,44,66,154
Suffolk,2018,Felony,42,85,189,61,103,480
Suffolk,2018,Misdemeanor,0,92,500,287,293,1172
Sullivan,2018,Felony,7,6,44,19,13,89
Sullivan,2018,Misdemeanor,0,11,26,29,42,108
Tioga,2018,Felony,4,20,2,3,5,34
Tioga,2018,Misdemeanor,0,10,6,26,18,60
Tompkins,2018,Felony,9,5,19,9,12,54
Tompkins,2018,Misdemeanor,0,19,31,44,44,138
Ulster,2018,Felony,2,7,45,7,21,82
Ulster,2018,Misdemeanor,0,46,45,87,125,303
Warren,2018,Felony,4,25,13,24,23,89
Warren,2018,Misdemeanor,0,26,27,54,78,185
Washington,2018,Felony,3,2,9,7,17,38
Washington,2018,Misdemeanor,0,10,17,23,18,68
Wayne,2018,Felony,7,3,29,6,9,54
Wayne,2018,Misdemeanor,0,7,19,29,44,99
Westchester,2018,Felony,68,32,125,77,135,437
Westchester,2018,Misdemeanor,0,142,242,269,412,1065
Wyoming,2018,Felony,2,3,10,4,14,33
Wyoming,2018,Misdemeanor,0,15,22,12,19,68
Yates,2018,Felony,1,7,11,8,8,35
Yates,2018,Misdemeanor,0,4,5,7,11,27
Unknown,2018,Misdemeanor,0,0,0,0,0,0
Albany,2019,Felony,12,39,51,17,69,188
Albany,2019,Misdemeanor,0,23,133,109,143,408
Allegany,2019,Felony,3,7,4,6,8,28
Allegany,2019,Misdemeanor,0,8,7,17,35,67
Bronx,2019,Felony,105,48,14,16,114,297
Bronx,2019,Misdemeanor,0,48,61,75,239,423
Broome,2019,Felony,33,43,27,27,52,182
Broome,2019,Misdemeanor,0,84,31,80,112,307
Cattaraugus,2019,Felony,1,20,20,7,22,70
Cattaraugus,2019,Misdemeanor,0,16,11,28,38,93
Cayuga,2019,Felony,4,14,13,4,10,45
Cayuga,2019,Misdemeanor,0,17,25,51,83,176
Chautauqua,2019,Felony,8,14,8,13,22,65
Chautauqua,2019,Misdemeanor,0,43,21,104,132,300
Chemung,2019,Felony,8,9,26,19,19,81
Chemung,2019,Misdemeanor,0,22,7,24,23,76
Chenango,2019,Felony,7,7,5,7,5,31
Chenango,2019,Misdemeanor,0,10,14,23,35,82
Clinton,2019,Felony,4,27,36,17,25,109
Clinton,2019,Misdemeanor,0,15,25,41,52,133
Columbia,2019,Felony,2,14,11,8,11,46
Columbia,2019,Misdemeanor,0,9,5,5,20,39
Cortland,2019,Felony,1,8,7,5,11,32
Cortland,2019,Misdemeanor,0,27,40,44,65,176
Delaware,2019,Felony,2,16,8,0,7,33
Delaware,2019,Misdemeanor,0,5,6,5,12,28
Dutchess,2019,Felony,6,21,49,25,39,140
Dutchess,2019,Misdemeanor,0,42,184,99,98,423
Erie,2019,Felony,173,46,93,51,98,461
Erie,2019,Misdemeanor,0,56,88,160,209,513
Essex,2019,Felony,0,4,8,1,3,16
Essex,2019,Misdemeanor,0,9,18,14,19,60
Franklin,2019,Felony,2,11,9,11,8,41
Franklin,2019,Misdemeanor,0,7,10,19,34,70
Fulton,2019,Felony,0,3,6,9,11,29
Fulton,2019,Misdemeanor,0,14,13,20,36,83
Genesee,2019,Felony,9,8,39,15,30,101
Genesee,2019,Misdemeanor,0,15,42,55,50,162
Greene,2019,Felony,0,8,8,6,8,30
Greene,2019,Misdemeanor,0,9,11,16,19,55
Hamilton,2019,Felony,0,1,2,1,1,5
Hamilton,2019,Misdemeanor,0,1,0,1,3,5
Herkimer,2019,Felony,4,0,16,10,13,43
Herkimer,2019,Misdemeanor,0,4,7,17,17,45
Jefferson,2019,Felony,15,36,17,16,24,108
Jefferson,2019,Misdemeanor,0,6,18,70,58,152
Kings,2019,Felony,80,35,26,44,161,346
Kings,2019,Misdemeanor,0,31,40,50,176,297
Lewis,2019,Felony,1,5,4,1,5,16
Lewis,2019,Misdemeanor,0,6,9,4,5,24
Livingston,2019,Felony,5,18,23,5,28,79
Livingston,2019,Misdemeanor,0,20,33,17,28,98
Madison,2019,Felony,4,5,11,8,4,32
Madison,2019,Misdemeanor,0,15,10,28,30,83
Monroe,2019,Felony,140,44,167,31,70,452
Monroe,2019,Misdemeanor,0,96,390,247,294,1027
Montgomery,2019,Felony,1,6,17,16,26,66
Montgomery,2019,Misdemeanor,0,9,6,26,38,79
Nassau,2019,Felony,39,63,212,50,162,526
Nassau,2019,Misdemeanor,0,268,739,252,475,1734
New York,2019,Felony,130,250,22,193,204,799
New York,2019,Misdemeanor,0,42,14,98,128,282
Niagara,2019,Felony,11,9,22,4,20,66
Niagara,2019,Misdemeanor,0,29,62,73,75,239
Oneida,2019,Felony,8,8,19,14,34,83
Oneida,2019,Misdemeanor,0,33,55,76,117,281
Onondaga,2019,Felony,57,76,51,60,112,356
Onondaga,2019,Misdemeanor,0,111,171,166,242,690
Ontario,2019,Felony,8,16,29,29,38,120
Ontario,2019,Misdemeanor,0,27,34,76,85,222
Orange,2019,Felony,21,53,102,40,57,273
Orange,2019,Misdemeanor,0,35,173,66,60,334
Orleans,2019,Felony,2,9,4,7,3,25
Orleans,2019,Misdemeanor,0,1,10,13,22,46
Oswego,2019,Felony,2,13,11,11,20,57
Oswego,2019,Misdemeanor,0,28,38,77,61,204
Otsego,2019,Felony,0,6,9,8,5,28
Otsego,2019,Misdemeanor,0,2,2,5,12,21
Putnam,2019,Felony,3,3,14,4,3,27
Putnam,2019,Misdemeanor,0,23,18,13,16,70
Queens,2019,Felony,93,28,58,62,103,344
Queens,2019,Misdemeanor,0,42,64,75,152,333
Rensselaer,2019,Felony,3,24,15,8,21,71
Rensselaer,2019,Misdemeanor,0,10,15,41,56,122
Richmond,2019,Felony,17,34,14,24,57,146
Richmond,2019,Misdemeanor,0,16,18,34,76,144
Rockland,2019,Felony,12,8,35,32,41,128
Rockland,2019,Misdemeanor,0,13,49,48,43,153
St. Lawrence,2019,Felony,6,19,9,15,24,73
St. Lawrence,2019,Misdemeanor,0,8,21,24,48,101
Saratoga,2019,Felony,5,22,40,26,35,128
Saratoga,2019,Misdemeanor,0,17,66,76,84,243
Schenectady,2019,Felony,11,20,28,10,14,83
Schenectady,2019,Misdemeanor,0,4,11,41,69,125
Schoharie,2019,Felony,2,2,6,11,4,25
Schoharie,2019,Misdemeanor,0,3,4,14,9,30
Schuyler,2019,Felony,2,5,5,6,2,20
Schuyler,2019,Misdemeanor,0,2,5,6,2,15
Seneca,2019,Felony,1,7,9,6,6,29
Seneca,2019,Misdemeanor,0,3,3,23,25,54
Steuben,2019,Felony,6,28,27,20,38,119
Steuben,2019,Misdemeanor,0,31,9,32,51,123
Suffolk,2019,Felony,59,78,176,55,104,472
Suffolk,2019,Misdemeanor,0,88,295,229,256,868
Sullivan,2019,Felony,9,8,31,20,21,89
Sullivan,2019,Misdemeanor,0,17,23,31,34,105
Tioga,2019,Felony,2,17,6,6,4,35
Tioga,2019,Misdemeanor,0,9,9,8,5,31
Tompkins,2019,Felony,8,2,16,2,13,41
Tompkins,2019,Misdemeanor,0,16,27,61,44,148
Ulster,2019,Felony,1,8,73,12,28,122
Ulster,2019,Misdemeanor,0,38,43,71,104,256
Warren,2019,Felony,11,19,17,16,20,83
Warren,2019,Misdemeanor,0,27,36,63,59,185
Washington,2019,Felony,4,0,7,5,8,24
Washington,2019,Misdemeanor,0,5,22,21,20,68
Wayne,2019,Felony,8,4,20,10,14,56
Wayne,2019,Misdemeanor,0,9,12,38,23,82
Westchester,2019,Felony,57,38,114,55,81,345
Westchester,2019,Misdemeanor,0,114,218,274,416,1022
Wyoming,2019,Felony,4,6,15,4,11,40
Wyoming,2019,Misdemeanor,0,12,27,16,21,76
Yates,2019,Felony,1,2,7,5,6,21
Yates,2019,Misdemeanor,0,2,5,5,11,23
